100平方米装修 => 100平方米装修
12平方米 => 12平方米
140平方米装修 => 140平方米装修
15万-30万 => 15万-30万
30万以上 => 30万以上
30平米小户型 => 30平米小户型
40平小户型 => 40平小户型
50平米小户型 => 50平米小户型
60平小户型 => 60平小户型
80平米小户型 => 80平米小户型
90平小户型 => 90平小户型
ABB => ABB
abb中国 => abb中国
abb中国有限公司 => abb中国有限公司
abb低压电器 => abb低压电器
abb公司 => abb公司
abb变压器 => abb变压器
abb变频器 => abb变频器
abb开关 => abb开关
abb接触器 => abb接触器
abb断路器 => abb断路器
abb电机 => abb电机
abb电气 => abb电气
abb电磁流量计 => abb电磁流量计
abb集团 => abb集团
ArtDeco风格 => ArtDeco风格
aucma => aucma
BOBO => BOBO
bosch => bosch
changhong => changhong
danfoss => danfoss
DIY花瓶 => DIY花瓶
diy鱼缸 => diy鱼缸
dulux => dulux
DVD => DVD
electrolux => electrolux
fotile => fotile
galanz => galanz
gree => gree
haier => haier
HarborHouse和佰佳居 => HarborHouse和佰佳居
hisense => hisense
hitachi => hitachi
IT一族 => IT一族
konka => konka
ktv => ktv
LED台灯 => LED台灯
LED日光灯 => LED日光灯
LED灯带 => LED灯带
LED灯条 => LED灯条
LED灯泡 => LED灯泡
LED灯管 => LED灯管
LED照明产品及城市公园路灯展 => LED照明产品及城市公园路灯展
LED节能灯 => LED节能灯
LG => LG
lg冰箱 => lg冰箱
lg显示器 => lg显示器
lg液晶电视 => lg液晶电视
lg电视 => lg电视
lg论坛 => lg论坛
littleswan => littleswan
Loft => Loft
LOMO风格 => LOMO风格
midea => midea
qq空间装修 => qq空间装修
rollei => rollei
royalstar => royalstar
samsung电视 => samsung电视
sanyo => sanyo
schneider => schneider
sharp电视 => sharp电视
skyworth => skyworth
SOHO => SOHO
sony电视 => sony电视
sony电视机 => sony电视机
st厦华 => st厦华
TATA => TATA
tata官网 => tata官网
tata实木门 => tata实木门
tata木门 => tata木门
tata门 => tata门
tata门业 => tata门业
TCL => TCL
tcl互联网电视 => tcl互联网电视
tcl冰箱 => tcl冰箱
tcl官网 => tcl官网
tcl洗衣机 => tcl洗衣机
tcl液晶电视 => tcl液晶电视
tcl照明 => tcl照明
tcl电视 => tcl电视
tcl空调 => tcl空调
tcl罗格朗 => tcl罗格朗
tcl集团有限公司 => tcl集团有限公司
tcl黄金眼 => tcl黄金眼
tt散热器 => tt散热器
xinfei => xinfei
一室户 => 一室户
70平小户型 => 70平小户型
一统家具 => 一统家具
一统家居 => 一统家居
一统木业 => 一统木业
一统木门 => 一统木门
万和热水器 => 万和热水器
万和燃气热水器 => 万和燃气热水器
万和电器 => 万和电器
万和集团 => 万和集团
万家乐壁挂炉 => 万家乐壁挂炉
万家乐官方网站 => 万家乐官方网站
万家乐抽油烟机 => 万家乐抽油烟机
万家乐油烟机 => 万家乐油烟机
万家乐热水器 => 万家乐热水器
万家乐燃气灶 => 万家乐燃气灶
万家乐燃气热水器 => 万家乐燃气热水器
万家乐电器 => 万家乐电器
万家乐电热水器 => 万家乐电热水器
万家乐集团 => 万家乐集团
万家灯火灯具城 => 万家灯火灯具城
万科白马花园 => 万科白马花园
三人餐桌 => 三人餐桌
三叶家私 => 三叶家私
三叶散热器 => 三叶散热器
三叶沙发 => 三叶沙发
三层实木地板 => 三层实木地板
三峰 => 三峰
三峰木业 => 三峰木业
三峰木门 => 三峰木门
三峰铜模雕刻 => 三峰铜模雕刻
三星led电视 => 三星led电视
三星冰箱 => 三星冰箱
三星洗衣机 => 三星洗衣机
三星液晶电视 => 三星液晶电视
三星电视机 => 三星电视机
三星空调 => 三星空调
三棵树乳胶漆 => 三棵树乳胶漆
三棵树健康漆 => 三棵树健康漆
三棵树墙面漆 => 三棵树墙面漆
三棵树木器漆 => 三棵树木器漆
三棵树漆 => 三棵树漆
三洋吸尘器 => 三洋吸尘器
三洋官方网站 => 三洋官方网站
三洋微波炉 => 三洋微波炉
三洋投影机 => 三洋投影机
三洋投影机灯泡 => 三洋投影机灯泡
三洋洗衣机 => 三洋洗衣机
三洋电器 => 三洋电器
三洋空调 => 三洋空调
三环锁 => 三环锁
三菱净水器 => 三菱净水器
三菱电机空调 => 三菱电机空调
三菱重工空调 => 三菱重工空调
上海abb => 上海abb
上海LED、新光源新能源节能照明展会 青岛国际LED、显示屏及城市节能照明展览会 => 上海LED、新光源新能源节能照明展会 青岛国际LED、显示屏及城市节能照明展览会
上海世博会中国馆 => 上海世博会中国馆
上海世博会主题 => 上海世博会主题
上海世博会图片 => 上海世博会图片
上海世博会志愿者 => 上海世博会志愿者
上海世博会新闻 => 上海世博会新闻
上海世博会资料 => 上海世博会资料
上海二手家电 => 上海二手家电
上海二手房装修 => 上海二手房装修
上海全包 => 上海全包
上海别墅装修 => 上海别墅装修
上海半包 => 上海半包
上海台灯 => 上海台灯
上海吉盛伟邦 => 上海吉盛伟邦
上海国美电器 => 上海国美电器
上海国际别墅及配套设施博览会 => 上海国际别墅及配套设施博览会
上海国际别墅及配套设施博览会 中国（上海）国际木制环保住宅博览会 => 上海国际别墅及配套设施博览会 中国（上海）国际木制环保住宅博览会
上海大金空调 => 上海大金空调
上海好美家 => 上海好美家
上海家具城 => 上海家具城
上海家纺 => 上海家纺
上海小户型装修 => 上海小户型装修
上海开荒保洁 => 上海开荒保洁
上海施耐德 => 上海施耐德
上海日丰 => 上海日丰
上海日立 => 上海日立
上海智能建筑展览会 => 上海智能建筑展览会
上海月星家居 => 上海月星家居
上海格力空调专卖店 => 上海格力空调专卖店
上海永乐电器 => 上海永乐电器
上海清包 => 上海清包
上海灯具城 => 上海灯具城
上海特力屋 => 上海特力屋
上海百安居 => 上海百安居
上海红星美凯龙 => 上海红星美凯龙
上海红苹果家具 => 上海红苹果家具
上海美克美家 => 上海美克美家
上海美巢 => 上海美巢
上海苏宁电器 => 上海苏宁电器
上海装修监理 => 上海装修监理
上海装潢 => 上海装潢
上海西门子 => 上海西门子
上海金海马家具城 => 上海金海马家具城
上海门窗幕墙玻璃展览会 => 上海门窗幕墙玻璃展览会
下沉式庭院 => 下沉式庭院
不粘锅 => 不粘锅
不锈钢地漏 => 不锈钢地漏
不锈钢橱柜 => 不锈钢橱柜
不锈钢餐具 => 不锈钢餐具
世博会丹麦馆 => 世博会丹麦馆
世博会南非馆 => 世博会南非馆
世博会历史 => 世博会历史
世博会台湾馆 => 世博会台湾馆
世博会埃及馆 => 世博会埃及馆
世博会山东馆 => 世博会山东馆
世博会巴西馆 => 世博会巴西馆
世博会希腊馆 => 世博会希腊馆
世博会德国馆 => 世博会德国馆
世博会意大利馆 => 世博会意大利馆
世博会新西兰馆 => 世博会新西兰馆
世博会日本馆 => 世博会日本馆
世博会残疾人馆 => 世博会残疾人馆
世博会河北馆 => 世博会河北馆
世博会法国馆 => 世博会法国馆
世博会澳大利亚馆 => 世博会澳大利亚馆
世博会澳门馆 => 世博会澳门馆
世博会美国馆 => 世博会美国馆
世博会英国馆 => 世博会英国馆
世博会韩国馆 => 世博会韩国馆
世博会香港馆 => 世博会香港馆
世博会马来西亚馆 => 世博会马来西亚馆
世友地板 => 世友地板
世友地板价格 => 世友地板价格
世友地板官方网站 => 世友地板官方网站
世友地板怎么样 => 世友地板怎么样
世友实木地板 => 世友实木地板
世贸家具城 => 世贸家具城
业界名人 => 业界名人
东丽比诺净水器 => 东丽比诺净水器
东南亚风格家具 => 东南亚风格家具
东方家园建材超市 => 东方家园建材超市
东方庭院 => 东方庭院
东方灯饰 => 东方灯饰
东方百盛家具 => 东方百盛家具
东方装饰 => 东方装饰
东明家具城 => 东明家具城
东梅 => 东梅
东芝42寸液晶电视 => 东芝42寸液晶电视
东芝液晶电视 => 东芝液晶电视
东芝电视机 => 东芝电视机
东菱 => 东菱
东菱水果豆浆机 => 东菱水果豆浆机
东菱电器 => 东菱电器
东菱豆浆机 => 东菱豆浆机
东菱集团 => 东菱集团
东菱面包机 => 东菱面包机
东鹏卫浴 => 东鹏卫浴
东鹏地砖 => 东鹏地砖
东鹏瓷砖 => 东鹏瓷砖
丝绸之路(新疆)国际建筑建材展览会 => 丝绸之路(新疆)国际建筑建材展览会
两岸建筑建材暨产品展 => 两岸建筑建材暨产品展
严涛 => 严涛
中东迪拜厨房卫浴展览会 => 中东迪拜厨房卫浴展览会
中保龙装饰 => 中保龙装饰
中国(上海)国际墙纸、壁纸布艺展览会 => 中国(上海)国际墙纸、壁纸布艺展览会
中国(上海)国际室内供暖系统、热泵及通风设备展览会 => 中国(上海)国际室内供暖系统、热泵及通风设备展览会
中国(上海)国际屋顶绿化和立体绿化展览会 => 中国(上海)国际屋顶绿化和立体绿化展览会
中国(上海)国际建材及室内装饰展览会 => 中国(上海)国际建材及室内装饰展览会
中国(上海)国际建筑节能及新型建材展览会 => 中国(上海)国际建筑节能及新型建材展览会
中国(上海)国际户外家具及休闲用品博览会 => 中国(上海)国际户外家具及休闲用品博览会
中国(上海)国际时尚家居用品展览会 => 中国(上海)国际时尚家居用品展览会
中国(北京)国际厨房卫浴设施展览会 => 中国(北京)国际厨房卫浴设施展览会
中国(北京)国际厨房卫浴设施展览会 中国国际橱柜、厨卫产品与技术博览会 => 中国(北京)国际厨房卫浴设施展览会 中国国际橱柜、厨卫产品与技术博览会
中国(北京)国际新型墙体材料及保温技术展览会 => 中国(北京)国际新型墙体材料及保温技术展览会
中国(北京)国际红木古典家具展览会 => 中国(北京)国际红木古典家具展览会
中国(广州)国际专业音响 => 中国(广州)国际专业音响
中国(广州)国际建筑钢结构展览会 => 中国(广州)国际建筑钢结构展览会
中国(成都)建筑装饰展览会 => 中国(成都)建筑装饰展览会
中国(郑州)国际泳池沐浴SPA展览会 => 中国(郑州)国际泳池沐浴SPA展览会
中国(重庆)建筑节能科技与设备展览会 => 中国(重庆)建筑节能科技与设备展览会
中国传统节日 => 中国传统节日
中国北京国际城市景观照明、LED展览会 重庆国际路灯、庭院灯及城市景观照明展 => 中国北京国际城市景观照明、LED展览会 重庆国际路灯、庭院灯及城市景观照明展
中国北京国际太阳能利用与热泵技术展览会 => 中国北京国际太阳能利用与热泵技术展览会
中国北京国际户外家具及休闲用品展览会 => 中国北京国际户外家具及休闲用品展览会
中国北京橱柜展览会 => 中国北京橱柜展览会
中国可持续建筑国际论坛暨木结构房屋产业展览会 => 中国可持续建筑国际论坛暨木结构房屋产业展览会
中国国际住宅产业博览会 => 中国国际住宅产业博览会
中国国际住宅产业博览会(住交会) => 中国国际住宅产业博览会(住交会)
中国国际土木工程结构试验与检测技术展览会 => 中国国际土木工程结构试验与检测技术展览会
中国国际家具博览会 => 中国国际家具博览会
中国国际家具及木工机械展览会 => 中国国际家具及木工机械展览会
中国国际家具木工机械（济南）展览会 => 中国国际家具木工机械（济南）展览会
中国国际建筑建材贸易博览会 => 中国国际建筑建材贸易博览会
中国国际建筑涂料、化学建材展览会 => 中国国际建筑涂料、化学建材展览会
中国国际建筑节能、保温、防水技术 建筑涂料展 => 中国国际建筑节能、保温、防水技术 建筑涂料展
中国国际建筑装饰及材料展览会 => 中国国际建筑装饰及材料展览会
中国国际建筑装饰展览会 => 中国国际建筑装饰展览会
中国国际建筑门窗、幕墙、玻璃技术与设备展览会 => 中国国际建筑门窗、幕墙、玻璃技术与设备展览会
中国国际橱柜 => 中国国际橱柜
中国国际现代混凝土建筑部品及应用展览会 => 中国国际现代混凝土建筑部品及应用展览会
中国国际红木古典家具展览会 => 中国国际红木古典家具展览会
中国国际装饰石材与设计应用展览会 => 中国国际装饰石材与设计应用展览会
中国国际设计艺术博览会 Interbath China中国国际泳池、浴场技术和桑拿理疗及康体设备博览 => 中国国际设计艺术博览会 Interbath China中国国际泳池、浴场技术和桑拿理疗及康体设备博览
中国国际高尚生活方式暨用品博览会 => 中国国际高尚生活方式暨用品博览会
中国威海国际人居节建博会 => 中国威海国际人居节建博会
中国家具城 => 中国家具城
中国建博会、中国国际建筑装饰五金及锁具展览会 => 中国建博会、中国国际建筑装饰五金及锁具展览会
中国慈溪家电博览会 => 中国慈溪家电博览会
中国慈溪家电配件展览会 => 中国慈溪家电配件展览会
中国日化产品原料及设备包装展览会 => 中国日化产品原料及设备包装展览会
中国日用百货商品交易会 => 中国日用百货商品交易会
中国日用百货商品交易会即中国现代家庭用品博览会 => 中国日用百货商品交易会即中国现代家庭用品博览会
中国步阳集团 => 中国步阳集团
中国沈阳国际家具博览会 => 中国沈阳国际家具博览会
中国沈阳国际节能环保与新能源产业博览会 => 中国沈阳国际节能环保与新能源产业博览会
中国西部(重庆)建筑节能门窗幕墙及玻璃工业展览会 => 中国西部(重庆)建筑节能门窗幕墙及玻璃工业展览会
中国西部国际建筑节能技术及新型建材展览会 => 中国西部国际建筑节能技术及新型建材展览会
中国郑州国际家具展览会 => 中国郑州国际家具展览会
中国重庆城市规划、建筑与景观设计展 => 中国重庆城市规划、建筑与景观设计展
中国重庆建筑装饰及绿色建材家居展览会 => 中国重庆建筑装饰及绿色建材家居展览会
中国重庆新型建筑防水技术及材料展 => 中国重庆新型建筑防水技术及材料展
中国（上海）国际照明灯饰展览会 => 中国（上海）国际照明灯饰展览会
中国（上海）国际门窗、幕墙与结构展览会 => 中国（上海）国际门窗、幕墙与结构展览会
中国（上海）装饰装修设备展 => 中国（上海）装饰装修设备展
中国（北京）国际建筑石材产品及设备博览 => 中国（北京）国际建筑石材产品及设备博览
中国（北京）国际门窗幕墙博览会 => 中国（北京）国际门窗幕墙博览会
中国（天津）国际石材产品及石材技术装备展览会 => 中国（天津）国际石材产品及石材技术装备展览会
中国（广州）国际建筑装饰博览会 => 中国（广州）国际建筑装饰博览会
中国（郑州）国际厨房用品及配套设施展览会 => 中国（郑州）国际厨房用品及配套设施展览会
中国（郑州）国际建筑装饰材料博览会 => 中国（郑州）国际建筑装饰材料博览会
中国（青岛）国际建筑材料及装饰材料博览会 => 中国（青岛）国际建筑材料及装饰材料博览会
中央净水器 => 中央净水器
中央空调品牌 => 中央空调品牌
中层漆 => 中层漆
中山花冠五金 => 中山花冠五金
中年夫妇 => 中年夫妇
中式书桌 => 中式书桌
中式别墅 => 中式别墅
中式古典风格 => 中式古典风格
中式吊灯 => 中式吊灯
中式客厅 => 中式客厅
中式屏风 => 中式屏风
中式庭院 => 中式庭院
中式灯具 => 中式灯具
中式田园风格 => 中式田园风格
中式背景墙 => 中式背景墙
中式隔断 => 中式隔断
中式餐桌 => 中式餐桌
中德管业 => 中德管业
中财管业 => 中财管业
中部厨房卫浴设施博览会暨大河电器节 => 中部厨房卫浴设施博览会暨大河电器节
中部时尚家居家装博览会 => 中部时尚家居家装博览会
临沂灯具城 => 临沂灯具城
临沂装饰城 => 临沂装饰城
丹下健三 => 丹下健三
丹佛斯中国 => 丹佛斯中国
丹佛斯地暖 => 丹佛斯地暖
丹佛斯电地暖 => 丹佛斯电地暖
丹麦风情 => 丹麦风情
主卧颜色 => 主卧颜色
久盛地板质量 => 久盛地板质量
久盛实木地板久盛地板价格 => 久盛实木地板久盛地板价格
义乌五金博览会 => 义乌五金博览会
义乌家装用品博览会 => 义乌家装用品博览会
乔德家纺 => 乔德家纺
九豪管业 => 九豪管业
九阳官网 => 九阳官网
九阳小家电 => 九阳小家电
九阳料理机 => 九阳料理机
九阳榨汁机 => 九阳榨汁机
九阳电压力锅 => 九阳电压力锅
九阳电器 => 九阳电器
九阳电磁炉 => 九阳电磁炉
九阳紫砂煲 => 九阳紫砂煲
九阳网站 => 九阳网站
九阳股份 => 九阳股份
九阳豆浆 => 九阳豆浆
九阳豆浆机 => 九阳豆浆机
九阳豆浆机型号 => 九阳豆浆机型号
九阳豆浆机官方网站 => 九阳豆浆机官方网站
九阳集团 => 九阳集团
书房吊顶 => 书房吊顶
书房灯 => 书房灯
书房窗帘 => 书房窗帘
书房隔断 => 书房隔断
书房颜色 => 书房颜色
书桌书柜 => 书桌书柜
书桌设计 => 书桌设计
二室一厅 => 二室一厅
二手家电 => 二手家电
二手床 => 二手床
二手房装修日记 => 二手房装修日记
二手房装修步骤 => 二手房装修步骤
二手沙发 => 二手沙发
二手洗衣机 => 二手洗衣机
五金产品 => 五金产品
五金制品 => 五金制品
五金锁具品牌 => 五金锁具品牌
亚光亚装饰 => 亚光亚装饰
亚明照明 => 亚明照明
亚枫管业 => 亚枫管业
亚洲最大建材展览会 上海）国际建筑节能及新型建材展览会 => 亚洲最大建材展览会 上海）国际建筑节能及新型建材展览会
亚细亚瓷砖 => 亚细亚瓷砖
亚细亚陶瓷 => 亚细亚陶瓷
亚都公司 => 亚都公司
亚都加湿器 => 亚都加湿器
亚都官网 => 亚都官网
亚都空气净化器 => 亚都空气净化器
亚都装修卫士 => 亚都装修卫士
交换空间装修 => 交换空间装修
人物装饰画 => 人物装饰画
今日五金 => 今日五金
仿古地砖 => 仿古地砖
仿古家具 => 仿古家具
仿古砖的贴法 => 仿古砖的贴法
仿瓷涂料 => 仿瓷涂料
仿瓷餐具 => 仿瓷餐具
伊奈洁具 => 伊奈洁具
伊莱克斯吸尘器 => 伊莱克斯吸尘器
伊莱克斯咖啡机 => 伊莱克斯咖啡机
伊莱克斯多士炉 => 伊莱克斯多士炉
伊莱克斯油烟机 => 伊莱克斯油烟机
伊莱克斯洗衣机 => 伊莱克斯洗衣机
伊莱克斯燃气灶 => 伊莱克斯燃气灶
伊莱克斯电磁炉 => 伊莱克斯电磁炉
伊莱克斯空调 => 伊莱克斯空调
休息室装修 => 休息室装修
休闲沙发 => 休闲沙发
优丽雅特 => 优丽雅特
优美家家具 => 优美家家具
会客厅装修 => 会客厅装修
伟星 => 伟星
伟星管 => 伟星管
伟星管业 => 伟星管业
伟星股份 => 伟星股份
伟星集团 => 伟星集团
伟星集团有限公司 => 伟星集团有限公司
伯艺 => 伯艺
伯艺木门 => 伯艺木门
何勍 => 何勍
余立 => 余立
佛罗伦萨散热器 => 佛罗伦萨散热器
依品木门 => 依品木门
依诺瓷砖 => 依诺瓷砖
依诺维绅 => 依诺维绅
俄罗斯莫斯科国际建材展览会 => 俄罗斯莫斯科国际建材展览会
保温杯 => 保温杯
修砌墙 => 修砌墙
健威家具 => 健威家具
傅东 => 傅东
储蓄罐 => 储蓄罐
储藏室装修 => 储藏室装修
儿童书桌 => 儿童书桌
儿童卧室 => 儿童卧室
儿童房吊顶 => 儿童房吊顶
儿童房手绘墙 => 儿童房手绘墙
儿童房窗帘 => 儿童房窗帘
儿童房色彩搭配 => 儿童房色彩搭配
儿童房装饰 => 儿童房装饰
儿童样板房 => 儿童样板房
儿童装饰画 => 儿童装饰画
儿童餐桌椅 => 儿童餐桌椅
允典红木家具 => 允典红木家具
元亨利家具 => 元亨利家具
元硕碳晶地暖 => 元硕碳晶地暖
充气床 => 充气床
充气沙发 => 充气沙发
充电台灯 => 充电台灯
先锋饮水机 => 先锋饮水机
兔宝宝板材 => 兔宝宝板材
全友家私 => 全友家私
全友家私家具 => 全友家私家具
全友家私家具图片 => 全友家私家具图片
全友家私床 => 全友家私床
全友家私沙发 => 全友家私沙发
全合装饰 => 全合装饰
全国铝门窗幕墙行业年会暨铝门窗幕墙新产品博览会 => 全国铝门窗幕墙行业年会暨铝门窗幕墙新产品博览会
八一家具城 => 八一家具城
八益床垫 => 八益床垫
公元管业 => 公元管业
公牛 => 公牛
公牛插座 => 公牛插座
公牛电器 => 公牛电器
兰州装修监理 => 兰州装修监理
兴辉瓷砖 => 兴辉瓷砖
兴辉陶瓷 => 兴辉陶瓷
兴隆家园建材城 => 兴隆家园建材城
其他 => 其他
其他卖场 => 其他卖场
其他家具 => 其他家具
其他展会 => 其他展会
其他照明 => 其他照明
其他空间 => 其他空间
其他风格 => 其他风格
其他餐具 => 其他餐具
其他饰品 => 其他饰品
内墙砖 => 内墙砖
冠军瓷砖 => 冠军瓷砖
冠牛木门 => 冠牛木门
冠珠-萨米特 => 冠珠-萨米特
冠珠仿古砖 => 冠珠仿古砖
冠珠卫浴 => 冠珠卫浴
冠珠地砖 => 冠珠地砖
冠珠瓷砖 => 冠珠瓷砖
冠珠陶瓷 => 冠珠陶瓷
冬天装修 => 冬天装修
冯克军 => 冯克军
冰淇淋店 => 冰淇淋店
冰箱压缩机 => 冰箱压缩机
凯捷散热器 => 凯捷散热器
凯盛家纺 => 凯盛家纺
凳 => 凳
刀 => 刀
刘力 => 刘力
刘小川 => 刘小川
创意书桌 => 创意书桌
创意礼品 => 创意礼品
创维创维电视 => 创维创维电视
创维官网 => 创维官网
创维液晶 => 创维液晶
创维液晶电视 => 创维液晶电视
创维电视官方网站 => 创维电视官方网站
创维网站 => 创维网站
创维美心防盗门 => 创维美心防盗门
创维酷开 => 创维酷开
创维酷开tv => 创维酷开tv
创维酷开电视 => 创维酷开电视
创维集团有限公司 => 创维集团有限公司
别墅庭院设计 => 别墅庭院设计
别墅楼梯 => 别墅楼梯
别墅设计北京别墅 => 别墅设计北京别墅
刺绣工艺品 => 刺绣工艺品
前置过滤器 => 前置过滤器
办公室装修风水 => 办公室装修风水
加西亚瓷砖 => 加西亚瓷砖
努奥罗散热器 => 努奥罗散热器
勺 => 勺
化妆品店 => 化妆品店
化妆间装修 => 化妆间装修
北七家建材城 => 北七家建材城
北京abb => 北京abb
北京二手家电 => 北京二手家电
北京二手房装修 => 北京二手房装修
北京厨卫展 => 北京厨卫展
北京国美电器 => 北京国美电器
北京地毯 => 北京地毯
北京壁纸墙纸布艺展览会 => 北京壁纸墙纸布艺展览会
北京好美家 => 北京好美家
北京宜家家居 => 北京宜家家居
北京家具城 => 北京家具城
北京小户型装修 => 北京小户型装修
北京居然之家 => 北京居然之家
北京建材城 => 北京建材城
北京开荒保洁 => 北京开荒保洁
北京曲美家具 => 北京曲美家具
北京李文锁城 => 北京李文锁城
北京橱柜 => 北京橱柜
北京灯具城 => 北京灯具城
北京特力屋 => 北京特力屋
北京百安居 => 北京百安居
北京第十四届国际建筑涂料展览会 => 北京第十四届国际建筑涂料展览会
北京红星美凯龙 => 北京红星美凯龙
北京美克美家 => 北京美克美家
北京节能环保房地产住宅产业博览会CIHAF第11届中国住交会建筑部品及建筑科技前沿展 => 北京节能环保房地产住宅产业博览会CIHAF第11届中国住交会建筑部品及建筑科技前沿展
北京苏宁电器 => 北京苏宁电器
北京装修监理 => 北京装修监理
北京门业展览会 => 北京门业展览会
北京门窗玻璃展---中国国际建筑装饰玻璃及门窗幕墙博览会 => 北京门窗玻璃展---中国国际建筑装饰玻璃及门窗幕墙博览会
北京集美家具城 => 北京集美家具城
北京香河家具城 => 北京香河家具城
北欧风情家具 => 北欧风情家具
北欧风格装修 => 北欧风格装修
十里河居然之家 => 十里河居然之家
十里河建材城 => 十里河建材城
十里河灯具城 => 十里河灯具城
千丽灯饰 => 千丽灯饰
千川木门 => 千川木门
升达地板 => 升达地板
华东装饰城 => 华东装饰城
华丰家具 => 华丰家具
华兴达装饰 => 华兴达装饰
华帝嵌入式煤气灶 => 华帝嵌入式煤气灶
华帝抽油烟机 => 华帝抽油烟机
华帝橱柜 => 华帝橱柜
华帝油烟机 => 华帝油烟机
华帝灶具 => 华帝灶具
华帝热水器 => 华帝热水器
华帝煤气灶 => 华帝煤气灶
华帝燃气灶 => 华帝燃气灶
华德地毯 => 华德地毯
华日实木家具 => 华日实木家具
华日家具 => 华日家具
华日挪威森林 => 华日挪威森林
华日木门 => 华日木门
华日沙发 => 华日沙发
华泰照明 => 华泰照明
华润油漆 => 华润油漆
华润漆价格 => 华润漆价格
华润漆官方网站 => 华润漆官方网站
华源轩家具 => 华源轩家具
华艺 => 华艺
华艺灯饰 => 华艺灯饰
华艺照明 => 华艺照明
华鹤 => 华鹤
华鹤实木门 => 华鹤实木门
华鹤家具 => 华鹤家具
华鹤木门 => 华鹤木门
华鹤集团 => 华鹤集团
华鹤集团有限公司 => 华鹤集团有限公司
南京二手家电 => 南京二手家电
南京二手房装修 => 南京二手房装修
南京别墅装修 => 南京别墅装修
南京好美家 => 南京好美家
南京宜家家居 => 南京宜家家居
南京家具城 => 南京家具城
南京月星家居 => 南京月星家居
南京橱柜 => 南京橱柜
南京百安居 => 南京百安居
南京美克美家 => 南京美克美家
南京苏宁电器 => 南京苏宁电器
南京装修 => 南京装修
南京装修监理 => 南京装修监理
南京装潢公司 => 南京装潢公司
南京装饰城 => 南京装饰城
南山散热器 => 南山散热器
南方寝饰 => 南方寝饰
南通红星美凯龙 => 南通红星美凯龙
博世中国 => 博世中国
博世公司 => 博世公司
博世冰箱 => 博世冰箱
博世力士乐 => 博世力士乐
博世壁挂炉 => 博世壁挂炉
博世家电 => 博世家电
博世洗衣机 => 博世洗衣机
博世热水器 => 博世热水器
博世电器 => 博世电器
博世音响 => 博世音响
博亮 => 博亮
博亮木门 => 博亮木门
博华陶瓷 => 博华陶瓷
博德瓷砖 => 博德瓷砖
博德陶瓷 => 博德陶瓷
博顿 => 博顿
博顿开关 => 博顿开关
卡拉特拉瓦 => 卡拉特拉瓦
卢求 => 卢求
卧室书房 => 卧室书房
卧室吊顶 => 卧室吊顶
卧室墙纸 => 卧室墙纸
卧室柜 => 卧室柜
卧室植物 => 卧室植物
卧室灯具 => 卧室灯具
卧室装修风水 => 卧室装修风水
卫浴其他 => 卫浴其他
卫浴博览会 中国国际橱柜 => 卫浴博览会 中国国际橱柜
卫浴挂件 => 卫浴挂件
卫生间墙砖 => 卫生间墙砖
卫生间瓷砖颜色 => 卫生间瓷砖颜色
卫生间用品 => 卫生间用品
卫生间装饰 => 卫生间装饰
卫生间贴砖 => 卫生间贴砖
卫生间防水 => 卫生间防水
卫生间隔断 => 卫生间隔断
卫生间颜色 => 卫生间颜色
卫生间风格 => 卫生间风格
印尼风格 => 印尼风格
厦华液晶电视 => 厦华液晶电视
厦华电视 => 厦华电视
厦华集团 => 厦华集团
厦门abb => 厦门abb
厨卫产品与技术博览会 => 厨卫产品与技术博览会
厨房墙砖 => 厨房墙砖
厨房瓷砖颜色 => 厨房瓷砖颜色
厨房电器品牌 => 厨房电器品牌
厨房装修风水 => 厨房装修风水
厨房隔断 => 厨房隔断
厨房颜色搭配 => 厨房颜色搭配
厨柜洁具展览会-厨卫展 => 厨柜洁具展览会-厨卫展
叉 => 叉
友邦集成吊顶 => 友邦集成吊顶
双清别墅 => 双清别墅
双虎木门 => 双虎木门
发型diy => 发型diy
古典书房 => 古典书房
另类宠物 => 另类宠物
台灯设计 => 台灯设计
史密斯热水器 => 史密斯热水器
史密斯燃气热水器 => 史密斯燃气热水器
史密斯电热水器 => 史密斯电热水器
史晓艳 => 史晓艳
司迈特饮水机 => 司迈特饮水机
各地美食 => 各地美食
合肥二手房装修 => 合肥二手房装修
合肥好美家 => 合肥好美家
合肥家具城 => 合肥家具城
合肥格力 => 合肥格力
合肥苏宁电器 => 合肥苏宁电器
吉事多卫浴 => 吉事多卫浴
吉斯床垫 => 吉斯床垫
吉盛伟邦家具村 => 吉盛伟邦家具村
同福易家丽 => 同福易家丽
名典瓷砖 => 名典瓷砖
名典陶瓷 => 名典陶瓷
吧凳 => 吧凳
吴厚斌 => 吴厚斌
吴晨曦 => 吴晨曦
吴钢 => 吴钢
周良 => 周良
和成洁具 => 和成洁具
和玺 => 和玺
和玺木门 => 和玺木门
品上照明 => 品上照明
品牌卖场 => 品牌卖场
哈尔滨月星家居 => 哈尔滨月星家居
哈尔滨红旗家具城 => 哈尔滨红旗家具城
哈尔滨苏宁电器 => 哈尔滨苏宁电器
哈尔滨装修 => 哈尔滨装修
哥特式风格 => 哥特式风格
哥特风格 => 哥特风格
唐山惠达卫浴 => 唐山惠达卫浴
唐山苏宁电器 => 唐山苏宁电器
喜临门家具 => 喜临门家具
喜来健按摩床 => 喜来健按摩床
喜来健按摩床的功效 => 喜来健按摩床的功效
喜来健温热理疗床 => 喜来健温热理疗床
喜来健负离子 => 喜来健负离子
喜来健负离子床垫 => 喜来健负离子床垫
喜梦宝 => 喜梦宝
喜梦宝儿童家具 => 喜梦宝儿童家具
喜梦宝实木家具 => 喜梦宝实木家具
嘉俊瓷砖 => 嘉俊瓷砖
嘉宝莉乳胶漆 => 嘉宝莉乳胶漆
嘉宝莉儿童漆 => 嘉宝莉儿童漆
嘉宝莉墙面漆 => 嘉宝莉墙面漆
嘉宝莉木器漆 => 嘉宝莉木器漆
嘉宝莉油漆 => 嘉宝莉油漆
嘉宝莉涂料 => 嘉宝莉涂料
嘉宝莉漆 => 嘉宝莉漆
四人餐桌 => 四人餐桌
回龙观建材城 => 回龙观建材城
园林别墅 => 园林别墅
园林椅 => 园林椅
园艺产品 => 园艺产品
园艺别墅 => 园艺别墅
园艺图片 => 园艺图片
园艺工具 => 园艺工具
园艺技术 => 园艺技术
园艺设计 => 园艺设计
固力锁 => 固力锁
国(上海)国际户外家具及休闲用品博览会 => 国(上海)国际户外家具及休闲用品博览会
国内设计师 => 国内设计师
国通管业 => 国通管业
国际地面装饰及地毯展览会 => 国际地面装饰及地毯展览会
国际室内供暖技术产品与设备展览会 => 国际室内供暖技术产品与设备展览会
国际广州钢管展览会广州管件展览会 => 国际广州钢管展览会广州管件展览会
国际建筑节能热泵冷暖热技术及中央热水展览会 => 国际建筑节能热泵冷暖热技术及中央热水展览会
国际木材及木制品展览会 => 国际木材及木制品展览会
图腾宝佳 => 图腾宝佳
图腾宝佳橱柜 => 图腾宝佳橱柜
圣保罗地板 => 圣保罗地板
圣像地板图片 => 圣像地板图片
圣春散热器 => 圣春散热器
圣诞工艺品 => 圣诞工艺品
圣象木门 => 圣象木门
地下室装修 => 地下室装修
地中海风格卫生间 => 地中海风格卫生间
地中海风格壁纸 => 地中海风格壁纸
地中海风格客厅 => 地中海风格客厅
地中海风格家具 => 地中海风格家具
地板其他 => 地板其他
地板找平 => 地板找平
地热采暖地板 => 地热采暖地板
地砖拼花 => 地砖拼花
地面找平 => 地面找平
地面找平价格 => 地面找平价格
垭口装修 => 垭口装修
城市装修 => 城市装修
基础建材品牌 => 基础建材品牌
基鸿装饰 => 基鸿装饰
堂皇家纺 => 堂皇家纺
塑料地毯 => 塑料地毯
塑料筐 => 塑料筐
塑胶地板 => 塑胶地板
塑钢窗 => 塑钢窗
墙体彩绘 => 墙体彩绘
墙壁开关 => 墙壁开关
墙皮 => 墙皮
墙纸基膜用法 => 墙纸基膜用法
墙面喷涂 => 墙面喷涂
墙面处理程序 => 墙面处理程序
墙面裂缝 => 墙面裂缝
墙面装修材料 => 墙面装修材料
壁挂鱼缸 => 壁挂鱼缸
壁纸品牌 => 壁纸品牌
壁纸背景墙 => 壁纸背景墙
复式楼梯 => 复式楼梯
复式跃层 => 复式跃层
夏普液晶电视 => 夏普液晶电视
夏普液晶电视机 => 夏普液晶电视机
夏普电视官网 => 夏普电视官网
夏普电视机 => 夏普电视机
外墙贴砖 => 外墙贴砖
多乐士乳胶漆 => 多乐士乳胶漆
多乐士价格 => 多乐士价格
多乐士墙面漆 => 多乐士墙面漆
多乐士好丽安 => 多乐士好丽安
多乐士官方网站 => 多乐士官方网站
多乐士家丽安 => 多乐士家丽安
多乐士涂料 => 多乐士涂料
多乐士漆 => 多乐士漆
多乐士色卡 => 多乐士色卡
多乐士超易洗 => 多乐士超易洗
多功能书桌 => 多功能书桌
多功能插座 => 多功能插座
多喜爱 => 多喜爱
多喜爱儿童套房 => 多喜爱儿童套房
多喜爱官方网站 => 多喜爱官方网站
多喜爱家具 => 多喜爱家具
多喜爱家具图片 => 多喜爱家具图片
多喜爱家纺 => 多喜爱家纺
多喜爱家纺官方网站 => 多喜爱家纺官方网站
多喜爱床上用品 => 多喜爱床上用品
多喜爱床品 => 多喜爱床品
多层实木地板 => 多层实木地板
多样屋毛浴巾组礼盒 => 多样屋毛浴巾组礼盒
大亚板材 => 大亚板材
大公馆家具 => 大公馆家具
大华锦绣华城 => 大华锦绣华城
大卫地板 => 大卫地板
大宝漆 => 大宝漆
大将军瓷砖 => 大将军瓷砖
大师牌乳胶漆 => 大师牌乳胶漆
大庆装修监理 => 大庆装修监理
大洋 => 大洋
大洋门业 => 大洋门业
大理石餐桌 => 大理石餐桌
大自然床垫 => 大自然床垫
大诚橱柜 => 大诚橱柜
大象漆 => 大象漆
大连三洋 => 大连三洋
大连二手房装修 => 大连二手房装修
大连华丰家具 => 大连华丰家具
大连国美电器 => 大连国美电器
大连宜家家居 => 大连宜家家居
大连橱柜 => 大连橱柜
大连苏宁电器 => 大连苏宁电器
大连装修 => 大连装修
大连装修监理公司 => 大连装修监理公司
大通散热器 => 大通散热器
大金家用中央空调 => 大金家用中央空调
大金空调 => 大金空调
大金空调维修 => 大金空调维修
大风范家具 => 大风范家具
天丽 => 天丽
天丽墙纸 => 天丽墙纸
天宇锁业 => 天宇锁业
天年净水器 => 天年净水器
天河木门 => 天河木门
天津丹佛斯 => 天津丹佛斯
天津二手房装修 => 天津二手房装修
天津别墅装修 => 天津别墅装修
天津国美电器 => 天津国美电器
天津好美家园 => 天津好美家园
天津家具城 => 天津家具城
天津红星美凯龙 => 天津红星美凯龙
天津美克美家 => 天津美克美家
天津苏宁电器 => 天津苏宁电器
天津装修 => 天津装修
天津装修监理 => 天津装修监理
天津装饰城 => 天津装饰城
天津金海马家具城 => 天津金海马家具城
天鹅椅 => 天鹅椅
天龙诚装饰 => 天龙诚装饰
太原居然之家 => 太原居然之家
太阳能采暖 => 太阳能采暖
太阳花散热器 => 太阳花散热器
头发保养 => 头发保养
奔腾小家电 => 奔腾小家电
奔腾电器 => 奔腾电器
奔腾电磁炉 => 奔腾电磁炉
奔腾电饭煲 => 奔腾电饭煲
奥克斯空调 => 奥克斯空调
奥克斯集团 => 奥克斯集团
奥克斯集团有限公司 => 奥克斯集团有限公司
奥尔灯具有限公司 => 奥尔灯具有限公司
奶罐 => 奶罐
好易居装饰 => 好易居装饰
好汉锁具 => 好汉锁具
好百年家居 => 好百年家居
好莱客整体衣柜 => 好莱客整体衣柜
好莱客衣柜 => 好莱客衣柜
威尔斯地砖 => 威尔斯地砖
威尔斯瓷砖 => 威尔斯瓷砖
威尔斯陶瓷 => 威尔斯陶瓷
威斯顿壁纸涂料 => 威斯顿壁纸涂料
威登堡瓷砖 => 威登堡瓷砖
威登堡陶瓷 => 威登堡陶瓷
威能壁挂炉 => 威能壁挂炉
嬉皮 => 嬉皮
孚日 => 孚日
孚日大家纺 => 孚日大家纺
孚日家纺 => 孚日家纺
孚日家纺官方网站 => 孚日家纺官方网站
孚日毛巾 => 孚日毛巾
孚日股份 => 孚日股份
孚日集团 => 孚日集团
学习桌 => 学习桌
宁波二手房装修 => 宁波二手房装修
宁波奥克斯 => 宁波奥克斯
宁波好美家 => 宁波好美家
宁波特力屋 => 宁波特力屋
宁波苏宁电器 => 宁波苏宁电器
宁波装修监理公司 => 宁波装修监理公司
宇邦橱柜 => 宇邦橱柜
安信地板价格 => 安信地板价格
安信实木地板 => 安信实木地板
安信强化地板 => 安信强化地板
安信木地板 => 安信木地板
安华洁具 => 安华洁具
安吉尔净水器 => 安吉尔净水器
安吉尔饮水机 => 安吉尔饮水机
安得装饰 => 安得装饰
安然 => 安然
安然壁纸 => 安然壁纸
安装门窗 => 安装门窗
安装门锁 => 安装门锁
宏宇地砖 => 宏宇地砖
宏宇瓷砖 => 宏宇瓷砖
宏宇陶瓷 => 宏宇陶瓷
宏宇集团 => 宏宇集团
宏陶瓷砖 => 宏陶瓷砖
宏陶陶瓷 => 宏陶陶瓷
宜家沙发 => 宜家沙发
宝燃气灶 => 宝燃气灶
宝缦家纺 => 宝缦家纺
实木书桌 => 实木书桌
实木地板保养 => 实木地板保养
实木地板种类 => 实木地板种类
实木楼梯 => 实木楼梯
实木沙发 => 实木沙发
实木窗 => 实木窗
实木衣帽间v衣帽间设计 => 实木衣帽间v衣帽间设计
实木餐桌 => 实木餐桌
实木餐桌椅 => 实木餐桌椅
宠物美容 => 宠物美容
宠物食品 => 宠物食品
客厅书房 => 客厅书房
客厅窗帘 => 客厅窗帘
客厅装修风水 => 客厅装修风水
客房装修 => 客房装修
室内植物 => 室内植物
室内盆栽植物 => 室内盆栽植物
室内观叶植物 => 室内观叶植物
家乐事净水器 => 家乐事净水器
家具五金 => 家具五金
家具材质 => 家具材质
家具油漆 => 家具油漆
家具用途 => 家具用途
家居房型 => 家居房型
家居生活版块 => 家居生活版块
家居用品展 => 家居用品展
家居空间 => 家居空间
家居装修风水 => 家居装修风水
家庭影音室装修 => 家庭影音室装修
家庭装修监理 => 家庭装修监理
家纺布艺床上用品品牌 => 家纺布艺床上用品品牌
家装色调搭配 => 家装色调搭配
家饰佳 => 家饰佳
容声集成吊顶 => 容声集成吊顶
密封罐 => 密封罐
富之岛 => 富之岛
富之岛家私 => 富之岛家私
富之岛床 => 富之岛床
富之岛沙发 => 富之岛沙发
富亚漆 => 富亚漆
富安娜 => 富安娜
富安娜家纺 => 富安娜家纺
富安娜家纺官方网站 => 富安娜家纺官方网站
富安娜床上用品 => 富安娜床上用品
富安娜床品 => 富安娜床品
富安娜艺术家 => 富安娜艺术家
富安娜蚕丝被 => 富安娜蚕丝被
富得宝家具 => 富得宝家具
富贵型 => 富贵型
尊典家具 => 尊典家具
小冰箱（迷你冰箱） => 小冰箱（迷你冰箱）
小台灯 => 小台灯
小天鹅bbs => 小天鹅bbs
小天鹅全自动洗衣机 => 小天鹅全自动洗衣机
小天鹅冰箱 => 小天鹅冰箱
小天鹅官方网站 => 小天鹅官方网站
小天鹅滚筒洗衣机 => 小天鹅滚筒洗衣机
小天鹅迷你洗衣机 => 小天鹅迷你洗衣机
小户型跃层 => 小户型跃层
小蜜蜂瓷砖 => 小蜜蜂瓷砖
小高层装修 => 小高层装修
局部空间装修 => 局部空间装修
山东(济南)家居博览会 => 山东(济南)家居博览会
山水盆景 => 山水盆景
山花地毯 => 山花地毯
州蠡口家具城 => 州蠡口家具城
工作台灯 => 工作台灯
工作室装修 => 工作室装修
工艺筷子 => 工艺筷子
左右家具 => 左右家具
左右布艺沙发 => 左右布艺沙发
左右皮沙发 => 左右皮沙发
巨星装饰 => 巨星装饰
巨迪橱柜 => 巨迪橱柜
巴塞罗那椅 => 巴塞罗那椅
巴洛克式建筑 => 巴洛克式建筑
巴洛克音乐 => 巴洛克音乐
布艺制作 => 布艺制作
布艺沙发套 => 布艺沙发套
布艺画 => 布艺画
布鲁斯特墙纸 => 布鲁斯特墙纸
帅康橱柜 => 帅康橱柜
帅康油烟机 => 帅康油烟机
帅康热水器 => 帅康热水器
帅康电器 => 帅康电器
帅康集团 => 帅康集团
常州惠达卫浴 => 常州惠达卫浴
常州月星家居 => 常州月星家居
常州灯具城 => 常州灯具城
常州红星美凯龙 => 常州红星美凯龙
年轻夫妇 => 年轻夫妇
广东国际建筑装饰展览会 => 广东国际建筑装饰展览会
广东国际照明展览会 => 广东国际照明展览会
广东家电配件、原材料及生产设备采购展览会 => 广东家电配件、原材料及生产设备采购展览会
广东联塑 => 广东联塑
广州二手房装修 => 广州二手房装修
广州吉盛伟邦 => 广州吉盛伟邦
广州国际古典家具展览会 => 广州国际古典家具展览会
广州国际奢侈品展 => 广州国际奢侈品展
广州宜家家居 => 广州宜家家居
广州家具城 => 广州家具城
广州百安居 => 广州百安居
广州苏宁电器 => 广州苏宁电器
广州藤艺居 => 广州藤艺居
床 => 床
床头背景墙 => 床头背景墙
座便器（马桶） => 座便器（马桶）
庭院植物 => 庭院植物
康佳公司 => 康佳公司
康佳冰箱 => 康佳冰箱
康佳团购 => 康佳团购
康佳官网 => 康佳官网
康佳液晶电视 => 康佳液晶电视
康佳电视 => 康佳电视
康佳集团 => 康佳集团
康宝橱柜 => 康宝橱柜
康宝油烟机 => 康宝油烟机
康宝消毒柜 => 康宝消毒柜
康宝电器 => 康宝电器
康泰管业 => 康泰管业
康洁橱柜 => 康洁橱柜
康浩 => 康浩
康耐登 => 康耐登
康耐登沙发 => 康耐登沙发
建材展/北京第十四届国际建筑建材及城市建设展览会 => 建材展/北京第十四届国际建筑建材及城市建设展览会
建材装饰展览会 => 建材装饰展览会
建筑展 => 建筑展
建筑节能展览会 => 建筑节能展览会
开元灯饰 => 开元灯饰
开关面板 => 开关面板
开开木门 => 开开木门
开心网房间装修 => 开心网房间装修
开放式衣帽间 => 开放式衣帽间
开荒保洁 杭州 => 开荒保洁 杭州
开荒保洁公司 => 开荒保洁公司
开荒保洁合同 => 开荒保洁合同
开荒保洁报价 => 开荒保洁报价
开荒保洁方案 => 开荒保洁方案
开荒保洁标准 => 开荒保洁标准
开荒保洁流程 => 开荒保洁流程
开荒保洁计划 => 开荒保洁计划
开达管业 => 开达管业
异度空间装饰 => 异度空间装饰
张永和 => 张永和
张瑛 => 张瑛
张钧 => 张钧
强力家具 => 强力家具
强力床垫 => 强力床垫
强辉地砖 => 强辉地砖
强辉瓷砖 => 强辉瓷砖
强辉精工砖 => 强辉精工砖
强辉陶瓷 => 强辉陶瓷
强辉陶瓷有限公司 => 强辉陶瓷有限公司
徐州红星美凯龙 => 徐州红星美凯龙
得高地板 => 得高地板
德国博世 => 德国博世
德国威能 => 德国威能
德国法兰克福国际时尚消费品展览会(秋季) => 德国法兰克福国际时尚消费品展览会(秋季)
德国科隆国际家具展览会 => 德国科隆国际家具展览会
德国西门子 => 德国西门子
德宝·西克曼 => 德宝·西克曼
德宝西克曼橱柜 => 德宝西克曼橱柜
德意厨具 => 德意厨具
德意橱柜 => 德意橱柜
德意油烟机 => 德意油烟机
德意燃气灶 => 德意燃气灶
德意电器 => 德意电器
德意集团 => 德意集团
德标管业 => 德标管业
德贝橱柜 => 德贝橱柜
心愿家纺 => 心愿家纺
志邦橱柜 => 志邦橱柜
志高油烟机 => 志高油烟机
志高空调 => 志高空调
志高集团 => 志高集团
恐龙家纺 => 恐龙家纺
恒源祥家纺 => 恒源祥家纺
恒源祥广告 => 恒源祥广告
恒源祥集团 => 恒源祥集团
恒福瓷砖 => 恒福瓷砖
恒福陶瓷 => 恒福陶瓷
情侣杯 => 情侣杯
愉悦家纺 => 愉悦家纺
意大利吊灯 => 意大利吊灯
意大利家居 => 意大利家居
意大利米兰国际冷暖设备及卫浴展览会MCE => 意大利米兰国际冷暖设备及卫浴展览会MCE
意风家具 => 意风家具
意风沙发 => 意风沙发
慕思凯奇 => 慕思凯奇
慕思凯奇家具 => 慕思凯奇家具
慕思凯奇家居 => 慕思凯奇家居
慕思凯奇软床 => 慕思凯奇软床
慕思床 => 慕思床
慕思床垫 => 慕思床垫
成都二手家电 => 成都二手家电
成都二手房装修 => 成都二手房装修
成都八一家具城 => 成都八一家具城
成都别墅装修 => 成都别墅装修
成都国美电器 => 成都国美电器
成都地毯 => 成都地毯
成都宜家家居 => 成都宜家家居
成都宜家家居地址 => 成都宜家家居地址
成都家具城 => 成都家具城
成都小户型装修 => 成都小户型装修
成都李文锁城 => 成都李文锁城
成都永乐电器 => 成都永乐电器
成都特力屋 => 成都特力屋
成都百安居 => 成都百安居
成都美克美家 => 成都美克美家
成都苏宁电器 => 成都苏宁电器
成都装修 => 成都装修
成都装修监理 => 成都装修监理
我乐橱柜 => 我乐橱柜
我爱我家 => 我爱我家
我爱我家儿童家具 => 我爱我家儿童家具
我爱我家家具 => 我爱我家家具
我爱我家建材超市 => 我爱我家建材超市
我爱我家灯饰 => 我爱我家灯饰
我爱我家灯饰大全 => 我爱我家灯饰大全
户外休闲椅 => 户外休闲椅
手工地毯 => 手工地毯
手工工艺品 => 手工工艺品
手绘装饰画 => 手绘装饰画
托玛琳床垫 => 托玛琳床垫
扬子地板价格 => 扬子地板价格
扬子地板怎么样 => 扬子地板怎么样
扬子复合地板 => 扬子复合地板
扬子木地板 => 扬子木地板
折叠书桌 => 折叠书桌
折叠凳 => 折叠凳
折叠桌 => 折叠桌
折叠餐桌 => 折叠餐桌
抚顺 => 抚顺
护眼台灯 => 护眼台灯
护肤保养 => 护肤保养
抽屉柜 => 抽屉柜
按摩床 => 按摩床
按键开关 => 按键开关
挑高客厅装修 => 挑高客厅装修
挑高小户型 => 挑高小户型
挑高设计 => 挑高设计
挑高隔层 => 挑高隔层
挪亚家家具 => 挪亚家家具
换季保养 => 换季保养
掌上明珠儿童床 => 掌上明珠儿童床
掌上明珠家具 => 掌上明珠家具
掌上明珠床 => 掌上明珠床
掌上明珠床垫 => 掌上明珠床垫
掌上明珠沙发 => 掌上明珠沙发
摇摇椅 => 摇摇椅
摩力克窗帘图片 => 摩力克窗帘图片
摩恩卫浴 => 摩恩卫浴
摩恩水槽 => 摩恩水槽
摩恩水龙头 => 摩恩水龙头
摩恩花洒 => 摩恩花洒
摩恩龙头 => 摩恩龙头
摩曼 => 摩曼
摩曼壁纸 => 摩曼壁纸
摩曼壁纸官方网站 => 摩曼壁纸官方网站
收纳凳 => 收纳凳
收纳盒diy => 收纳盒diy
数字钟 => 数字钟
整理箱 => 整理箱
文具礼品 => 文具礼品
文物收藏 => 文物收藏
斯帝罗兰沙发 => 斯帝罗兰沙发
斯普丽家具 => 斯普丽家具
斯林百兰床垫 => 斯林百兰床垫
斯米克地砖 => 斯米克地砖
斯米克玻化砖 => 斯米克玻化砖
斯米克瓷砖 => 斯米克瓷砖
斯米克陶瓷 => 斯米克陶瓷
斯米克集团 => 斯米克集团
新中基装饰 => 新中基装饰
新中源仿古砖 => 新中源仿古砖
新中源卫浴 => 新中源卫浴
新中源地砖 => 新中源地砖
新中源瓷砖 => 新中源瓷砖
新中源陶瓷 => 新中源陶瓷
新中源集团 => 新中源集团
新古典风格 => 新古典风格
新国展卫浴洁具展会 => 新国展卫浴洁具展会
新型涂料 => 新型涂料
新特丽 => 新特丽
新特丽灯具 => 新特丽灯具
新特丽灯饰 => 新特丽灯饰
新特丽照明 => 新特丽照明
新科空调 => 新科空调
新飞 => 新飞
新飞冰箱 => 新飞冰箱
新飞太阳能 => 新飞太阳能
新飞官网 => 新飞官网
新飞小家电 => 新飞小家电
新飞抽油烟机 => 新飞抽油烟机
新飞散热器 => 新飞散热器
新飞电器 => 新飞电器
新飞空调 => 新飞空调
新飞豆浆机 => 新飞豆浆机
新飞集团 => 新飞集团
方块地毯 => 方块地毯
方太厨具 => 方太厨具
方太抽油烟机 => 方太抽油烟机
方太柏厨 => 方太柏厨
方太橱柜 => 方太橱柜
方太油烟机 => 方太油烟机
方太消毒柜 => 方太消毒柜
方太灶具 => 方太灶具
方太热水器 => 方太热水器
方太燃气灶 => 方太燃气灶
方太电器 => 方太电器
方太集团 => 方太集团
方正管业 => 方正管业
施耐德万高 => 施耐德万高
施耐德中国 => 施耐德中国
施耐德变频器 => 施耐德变频器
施耐德开关 => 施耐德开关
施耐德接触器 => 施耐德接触器
施耐德断路器 => 施耐德断路器
施耐德电器 => 施耐德电器
施耐德电气中国 => 施耐德电气中国
施耐德网站 => 施耐德网站
无框装饰画 => 无框装饰画
无锡二手房装修 => 无锡二手房装修
无锡博世 => 无锡博世
无锡小天鹅 => 无锡小天鹅
无锡小户型装修 => 无锡小户型装修
无锡月星家居 => 无锡月星家居
无锡特力屋 => 无锡特力屋
无锡百安居 => 无锡百安居
无锡红星美凯龙 => 无锡红星美凯龙
无锡装潢 => 无锡装潢
无锡金海马家具城 => 无锡金海马家具城
日上 => 日上
日上散热器 => 日上散热器
日上防盗门 => 日上防盗门
日丰 => 日丰
日丰水管 => 日丰水管
日丰管 => 日丰管
日丰管业 => 日丰管业
日丰管业集团 => 日丰管业集团
日丰铝塑管 => 日丰铝塑管
日式庭院 => 日式庭院
日式装修 => 日式装修
日本三洋 => 日本三洋
日本东京国际办公家具展览会 => 日本东京国际办公家具展览会
日本东京国际家具展IFFT-ILL => 日本东京国际家具展IFFT-ILL
日立neso => 日立neso
日立中国 => 日立中国
日立中央空调 => 日立中央空调
日立公司 => 日立公司
日立官网 => 日立官网
日立投影机 => 日立投影机
日立洗衣机 => 日立洗衣机
日立液晶电视 => 日立液晶电视
日立电视 => 日立电视
日立等离子电视 => 日立等离子电视
旭日装饰 => 旭日装饰
时尚衣帽间 => 时尚衣帽间
昆山红星美凯龙 => 昆山红星美凯龙
昆明百安居 => 昆明百安居
昆明苏宁电器 => 昆明苏宁电器
星冠漆 => 星冠漆
星星套装门 => 星星套装门
星港床垫 => 星港床垫
春天防盗门 => 春天防盗门
春季保养 => 春季保养
春季广交会 => 春季广交会
晚安床垫 => 晚安床垫
普田 => 普田
普田抽油烟机 => 普田抽油烟机
普田橱柜 => 普田橱柜
普田油烟机 => 普田油烟机
普田燃气灶 => 普田燃气灶
普田燃气灶维修 => 普田燃气灶维修
景德镇茶具 => 景德镇茶具
景观设计 => 景观设计
智能家居平面设计 => 智能家居平面设计
曲美实木家具 => 曲美实木家具
曲美布艺沙发 => 曲美布艺沙发
曲美沙发 => 曲美沙发
曲美现代家具 => 曲美现代家具
曲雷 => 曲雷
曹安闽 => 曹安闽
月兔橱柜 => 月兔橱柜
月星家居 => 月星家居
朗能开关 => 朗能开关
朗能开关插座 => 朗能开关插座
朗能灯具 => 朗能灯具
朗能照明 => 朗能照明
朗饰 => 朗饰
朗饰壁纸 => 朗饰壁纸
朝阳卫浴 => 朝阳卫浴
木制工艺品 => 木制工艺品
木地板保养 => 木地板保养
木地板分类 => 木地板分类
木地板安装 => 木地板安装
木地板材质 => 木地板材质
木地板的选择 => 木地板的选择
木地板种类 => 木地板种类
木地板规格 => 木地板规格
木地板颜色 => 木地板颜色
木工及室内装饰展 => 木工及室内装饰展
木柜 => 木柜
木门品牌 => 木门品牌
木雕工艺品 => 木雕工艺品
本钢板材 => 本钢板材
杂志架 => 杂志架
李兴国 => 李兴国
李文锁城 => 李文锁城
杨嘉沁 => 杨嘉沁
杨子明 => 杨子明
杨庆琦 => 杨庆琦
杨建伟 => 杨建伟
杨晨 => 杨晨
杭州二手房装修 => 杭州二手房装修
杭州别墅装修 => 杭州别墅装修
杭州国美电器 => 杭州国美电器
杭州小户型装修 => 杭州小户型装修
杭州永乐电器 => 杭州永乐电器
杭州特力屋 => 杭州特力屋
杭州百安居 => 杭州百安居
杭州红星美凯龙 => 杭州红星美凯龙
杭州苏宁电器 => 杭州苏宁电器
杯 => 杯
松下中国 => 松下中国
松下优也 => 松下优也
松下公司 => 松下公司
松下冰箱 => 松下冰箱
松下官网 => 松下官网
松下幸之助 => 松下幸之助
松下微波炉松下中央空调 => 松下微波炉松下中央空调
松下投影机 => 松下投影机
松下照明 => 松下照明
松下电视 => 松下电视
松下空调 => 松下空调
松下等离子 => 松下等离子
松下等离子电视 => 松下等离子电视
松下网站 => 松下网站
松木家具 => 松木家具
板 => 板
林世彤 => 林世彤
林卫 => 林卫
林学明 => 林学明
林牌地板 => 林牌地板
架 => 架
柏丽橱柜 => 柏丽橱柜
柏家居家具 => 柏家居家具
柔然壁纸 => 柔然壁纸
柔然壁纸官方网站 => 柔然壁纸官方网站
柜 => 柜
标卓家具 => 标卓家具
标卓沙发 => 标卓沙发
标致家具 => 标致家具
树之语家具 => 树之语家具
树脂工艺品 => 树脂工艺品
格兰仕光波炉 => 格兰仕光波炉
格兰仕官网 => 格兰仕官网
格兰仕微波炉 => 格兰仕微波炉
格兰仕烤箱 => 格兰仕烤箱
格兰仕电压力锅 => 格兰仕电压力锅
格兰仕电烤箱 => 格兰仕电烤箱
格兰仕电磁炉 => 格兰仕电磁炉
格兰仕电饭煲 => 格兰仕电饭煲
格兰仕网站 => 格兰仕网站
格兰仕集团 => 格兰仕集团
格力中央空调 => 格力中央空调
格力传奇故事 => 格力传奇故事
格力太阳能 => 格力太阳能
格力官网 => 格力官网
格力家用中央空调 => 格力家用中央空调
格力小家电 => 格力小家电
格力热水器 => 格力热水器
格力电磁炉 => 格力电磁炉
格力空调专卖店 => 格力空调专卖店
格力空调型号 => 格力空调型号
格力空调官方网站 => 格力空调官方网站
格力空调网站 => 格力空调网站
格力网站 => 格力网站
格莱斯瓷砖 => 格莱斯瓷砖
格莱斯陶瓷 => 格莱斯陶瓷
格莱美墙纸 => 格莱美墙纸
桃木工艺品 => 桃木工艺品
案桌 => 案桌
桌 => 桌
梅雨季节装修 => 梅雨季节装修
梦天 => 梦天
梦天实木门 => 梦天实木门
梦天木业 => 梦天木业
梦天木门 => 梦天木门
梦天门业 => 梦天门业
梦洁 => 梦洁
梦洁家纺 => 梦洁家纺
梦洁家纺官方网站 => 梦洁家纺官方网站
梦洁床上用品 => 梦洁床上用品
梦洁床垫 => 梦洁床垫
梦洁蚕丝被 => 梦洁蚕丝被
森德散热器 => 森德散热器
椅 => 椅
楚楚吊顶 => 楚楚吊顶
楷模家具 => 楷模家具
楷模木门 => 楷模木门
楷模沙发 => 楷模沙发
楼房装修风水 => 楼房装修风水
楼梯灯 => 楼梯灯
榆木家具 => 榆木家具
樱花厨具 => 樱花厨具
樱花厨卫 => 樱花厨卫
樱花家纺 => 樱花家纺
樱花抽油烟机 => 樱花抽油烟机
樱花橱柜 => 樱花橱柜
樱花油烟机 => 樱花油烟机
樱花热水器 => 樱花热水器
樱花燃气灶 => 樱花燃气灶
樱花电器 => 樱花电器
橱柜品牌 => 橱柜品牌
橱柜颜色 => 橱柜颜色
橱柜高度 => 橱柜高度
欧人地板 => 欧人地板
欧利雅 => 欧利雅
欧利雅木门 => 欧利雅木门
欧利雅木门专卖店 => 欧利雅木门专卖店
欧利雅木门十大品牌 => 欧利雅木门十大品牌
欧利雅木门品牌 => 欧利雅木门品牌
欧式书桌 => 欧式书桌
欧式儿童房 => 欧式儿童房
欧式卧室 => 欧式卧室
欧式吊灯 => 欧式吊灯
欧式沙发 => 欧式沙发
欧式背景墙 => 欧式背景墙
欧式装饰画 => 欧式装饰画
欧式隔断 => 欧式隔断
欧式风格家具 => 欧式风格家具
欧式餐桌 => 欧式餐桌
欧普灯具 => 欧普灯具
欧普节能灯 => 欧普节能灯
欧普集成吊顶 => 欧普集成吊顶
欧洲家居 => 欧洲家居
欧派卫浴 => 欧派卫浴
欧派整体橱柜 => 欧派整体橱柜
欧派木门 => 欧派木门
欧派橱柜 => 欧派橱柜
欧派集成吊顶 => 欧派集成吊顶
欧琳橱柜 => 欧琳橱柜
欧神诺地砖 => 欧神诺地砖
欧神诺瓷砖 => 欧神诺瓷砖
欧神诺陶瓷 => 欧神诺陶瓷
欧美瓷砖 => 欧美瓷砖
欧雅 => 欧雅
欧雅壁纸 => 欧雅壁纸
步阳 => 步阳
步阳室内门 => 步阳室内门
步阳门 => 步阳门
步阳门业 => 步阳门业
步阳防盗门 => 步阳防盗门
步阳防盗门官方网站 => 步阳防盗门官方网站
步阳集团 => 步阳集团
步阳集团有限公司 => 步阳集团有限公司
武汉二手房装修 => 武汉二手房装修
武汉别墅装修 => 武汉别墅装修
武汉国美电器 => 武汉国美电器
武汉好美家 => 武汉好美家
武汉家具城 => 武汉家具城
武汉小户型装修 => 武汉小户型装修
武汉居然之家 => 武汉居然之家
武汉李文锁城 => 武汉李文锁城
武汉百安居 => 武汉百安居
武汉苏宁电器 => 武汉苏宁电器
武汉装修 => 武汉装修
武汉装饰城 => 武汉装饰城
殷智贤 => 殷智贤
气垫床 => 气垫床
水墙 => 水墙
水处理品牌 => 水处理品牌
水星家纺 => 水星家纺
水星家纺官方网站 => 水星家纺官方网站
水晶吊灯 => 水晶吊灯
水晶家纺 => 水晶家纺
水晶帘 => 水晶帘
水晶花瓶 => 水晶花瓶
水晶马赛克 => 水晶马赛克
水泥橱柜 => 水泥橱柜
水电改造合同 => 水电改造合同
水电改造报价 => 水电改造报价
水电改造材料 => 水电改造材料
水电改造注意事项 => 水电改造注意事项
水电改造装修日记 => 水电改造装修日记
水电改造费用 => 水电改造费用
水电改造验收 => 水电改造验收
水管品牌 => 水管品牌
永乐家电 => 永乐家电
永吉地板 => 永吉地板
汇丽地板 => 汇丽地板
汇亚陶瓷 => 汇亚陶瓷
汇德邦瓷砖 => 汇德邦瓷砖
汇德邦陶瓷 => 汇德邦陶瓷
汉唐茶具 => 汉唐茶具
江苏蠡口国际家具城 => 江苏蠡口国际家具城
汽车地毯 => 汽车地毯
沁园净水器 => 沁园净水器
沁园家用净水器 => 沁园家用净水器
沁园饮水机 => 沁园饮水机
沈帆 => 沈帆
沈阳二手家电 => 沈阳二手家电
沈阳二手房装修 => 沈阳二手房装修
沈阳国美电器 => 沈阳国美电器
沈阳家具城 => 沈阳家具城
沈阳小户型装修 => 沈阳小户型装修
沈阳居然之家 => 沈阳居然之家
沈阳红星美凯龙 => 沈阳红星美凯龙
沈阳苏宁电器 => 沈阳苏宁电器
沈阳装修 => 沈阳装修
沈阳金德管业集团 => 沈阳金德管业集团
沙发颜色 => 沙发颜色
沙滩椅 => 沙滩椅
油漆专卖店 => 油漆专卖店
油漆密度 => 油漆密度
油漆工艺 => 油漆工艺
油漆成分 => 油漆成分
油漆笔 => 油漆笔
油漆色卡 => 油漆色卡
油漆过敏 => 油漆过敏
泉来净水器 => 泉来净水器
法国巴黎国际建筑建材展 => 法国巴黎国际建筑建材展
波兰国际照明及LED展览会韩国国际LED&FPD照明展 => 波兰国际照明及LED展览会韩国国际LED&FPD照明展
波斯地毯 => 波斯地毯
泰安居然之家 => 泰安居然之家
泰山石膏板 => 泰山石膏板
泰式风格 => 泰式风格
洁丽雅 => 洁丽雅
洁丽雅毛巾 => 洁丽雅毛巾
洁丽雅毛巾官方网站 => 洁丽雅毛巾官方网站
洁丽雅集团 => 洁丽雅集团
洁丽雅集团有限公司 => 洁丽雅集团有限公司
洁具汉斯格雅 => 洁具汉斯格雅
洗地毯 => 洗地毯
洛可可家具 => 洛可可家具
洛可可建筑 => 洛可可建筑
洛可可设计 => 洛可可设计
洛可可风格 => 洛可可风格
洛阳红星美凯龙 => 洛阳红星美凯龙
活动屏风v漆器屏风 => 活动屏风v漆器屏风
派斯净水器 => 派斯净水器
流水别墅 => 流水别墅
济南二手房装修 => 济南二手房装修
济南国美电器 => 济南国美电器
济南小户型装修 => 济南小户型装修
济南居然之家 => 济南居然之家
济南苏宁电器 => 济南苏宁电器
济南装修 => 济南装修
浪木净水器 => 浪木净水器
浪木饮水机 => 浪木饮水机
浪鲸卫浴 => 浪鲸卫浴
浴室隔断 => 浴室隔断
浴室风水 => 浴室风水
海信led => 海信led
海信冰箱 => 海信冰箱
海信变频空调 => 海信变频空调
海信官网 => 海信官网
海信洗衣机 => 海信洗衣机
海信集团有限公司 => 海信集团有限公司
海创集成吊顶 => 海创集成吊顶
海外家居 => 海外家居
海洋王照明 => 海洋王照明
海马地毯 => 海马地毯
海鸟装饰设计 => 海鸟装饰设计
涂料其他 => 涂料其他
涂料品牌 => 涂料品牌
液体壁纸壁布 => 液体壁纸壁布
淄博红星美凯龙 => 淄博红星美凯龙
淋浴隔断 => 淋浴隔断
淘宝店铺装修 => 淘宝店铺装修
淘宝搜店 => 淘宝搜店
淘宝收藏 => 淘宝收藏
深圳二手房装修 => 深圳二手房装修
深圳创维 => 深圳创维
深圳国美电器 => 深圳国美电器
深圳宜家家居 => 深圳宜家家居
深圳深城办公室装饰 => 深圳深城办公室装饰
深圳深城装饰 => 深圳深城装饰
深圳深城装饰公司 => 深圳深城装饰公司
深圳百安居 => 深圳百安居
深圳苏宁电器 => 深圳苏宁电器
深圳（国际)文具及现代办公博览会 中 => 深圳（国际)文具及现代办公博览会 中
深城办公室装饰 => 深城办公室装饰
深城装饰公司 => 深城装饰公司
混水漆 => 混水漆
温州苏宁电器 => 温州苏宁电器
澳克士 => 澳克士
澳克士灯饰 => 澳克士灯饰
澳克士照明 => 澳克士照明
澳大利亚国际建材展览会 => 澳大利亚国际建材展览会
澳大利亚建材家装促进展 => 澳大利亚建材家装促进展
澳大利亚悉尼家具展览会 => 澳大利亚悉尼家具展览会
澳柯玛冰箱 => 澳柯玛冰箱
澳柯玛太阳能 => 澳柯玛太阳能
澳柯玛散热器 => 澳柯玛散热器
澳柯玛整体厨房 => 澳柯玛整体厨房
澳柯玛橱柜 => 澳柯玛橱柜
澳柯玛空调青岛澳柯玛 => 澳柯玛空调青岛澳柯玛
澳柯玛集团 => 澳柯玛集团
澳西奴官网 => 澳西奴官网
澳西奴家纺 => 澳西奴家纺
澳门装修 => 澳门装修
灯 => 灯
灯光展览会 => 灯光展览会
灯具配件 => 灯具配件
灯饰制造 => 灯饰制造
灯饰品牌 => 灯饰品牌
烤杯机 => 烤杯机
熊猫电线 => 熊猫电线
爱家家居 => 爱家家居
爱康管业 => 爱康管业
爱惠普净水器 => 爱惠普净水器
爱惠浦净水器 => 爱惠浦净水器
爱玛特净水器 => 爱玛特净水器
爱舍 => 爱舍
爱舍墙纸 => 爱舍墙纸
爱舒床垫 => 爱舒床垫
爱蒙床垫 => 爱蒙床垫
玉兰墙纸 => 玉兰墙纸
玉庭家具 => 玉庭家具
玉石工艺品 => 玉石工艺品
玉石床垫 => 玉石床垫
王先 => 王先
王力安全门 => 王力安全门
王力门 => 王力门
王力门业 => 王力门业
王力防盗门 => 王力防盗门
王力防盗门官方网站 => 王力防盗门官方网站
王力集团 => 王力集团
王力集团有限公司 => 王力集团有限公司
王朝木门 => 王朝木门
王永刚 => 王永刚
王者瓷砖 => 王者瓷砖
王者陶瓷 => 王者陶瓷
玥玛锁 => 玥玛锁
玥玛锁具 => 玥玛锁具
环保餐具 => 环保餐具
环形灯管 => 环形灯管
环渤海装饰城 => 环渤海装饰城
环球资源春季香港家居用品展 => 环球资源春季香港家居用品展
现代中式风格 => 现代中式风格
现代书房 => 现代书房
现代家庭用品博览会 => 现代家庭用品博览会
现代装饰画 => 现代装饰画
玻璃屏风 => 玻璃屏风
玻璃工艺品 => 玻璃工艺品
玻璃柜 => 玻璃柜
玻璃楼梯 => 玻璃楼梯
玻璃油漆 => 玻璃油漆
玻璃背景墙 => 玻璃背景墙
玻璃花瓶 => 玻璃花瓶
玻璃茶具 => 玻璃茶具
玻璃隔断墙 => 玻璃隔断墙
玻璃餐具 => 玻璃餐具
玻璃马赛克 => 玻璃马赛克
玻璃鱼缸 => 玻璃鱼缸
珠江装饰城 => 珠江装饰城
珠海格力 => 珠海格力
珠海格力空调 => 珠海格力空调
珠海格力集团公司 => 珠海格力集团公司
琉璃工艺品 => 琉璃工艺品
琪朗灯饰 => 琪朗灯饰
瑞宝壁纸 => 瑞宝壁纸
瑞阁橱柜 => 瑞阁橱柜
瓷砖其他 => 瓷砖其他
生态鱼缸 => 生态鱼缸
田园风格卧室 => 田园风格卧室
田园风格卧饰 => 田园风格卧饰
田园风格卫生间 => 田园风格卫生间
田园风格壁纸 => 田园风格壁纸
田园风格客厅 => 田园风格客厅
田园风格家具 => 田园风格家具
田园风格沙发 => 田园风格沙发
田园风格窗帘 => 田园风格窗帘
申作伟 => 申作伟
申鹭达卫浴 => 申鹭达卫浴
申鹭达水龙头 => 申鹭达水龙头
申鹭达洁具 => 申鹭达洁具
申鹭达花洒 => 申鹭达花洒
申鹭达集团 => 申鹭达集团
申鹭达集团有限公司 => 申鹭达集团有限公司
电动天棚帘 => 电动天棚帘
电子钟 => 电子钟
电工开关品牌 => 电工开关品牌
电源插座 => 电源插座
电热杯 => 电热杯
电热锅 => 电热锅
电脑椅 => 电脑椅
电视背景墙设计 => 电视背景墙设计
电话台灯 => 电话台灯
电采暖壁挂炉 => 电采暖壁挂炉
留言板 => 留言板
白联 => 白联
白蝶管业 => 白蝶管业
白领公寓 => 白领公寓
百v橱柜 => 百v橱柜
百特地砖 => 百特地砖
百特瓷砖 => 百特瓷砖
百特陶瓷 => 百特陶瓷
百诗散热器 => 百诗散热器
百诺肯净水器 => 百诺肯净水器
皇冠陶瓷 => 皇冠陶瓷
皇朝家私布艺沙发 => 皇朝家私布艺沙发
皇朝家私床 => 皇朝家私床
皇朝家私沙发 => 皇朝家私沙发
皇朝家私衣柜 => 皇朝家私衣柜
皖宝床垫 => 皖宝床垫
盆景艺术 => 盆景艺术
益有橱柜 => 益有橱柜
盘 => 盘
盛宇家纺 => 盛宇家纺
相架 => 相架
盼盼 => 盼盼
盼盼室内门 => 盼盼室内门
盼盼散热器 => 盼盼散热器
盼盼木门 => 盼盼木门
盼盼门 => 盼盼门
盼盼门业 => 盼盼门业
盼盼防盗门 => 盼盼防盗门
盼盼防盗门官方网站 => 盼盼防盗门官方网站
盼盼集团 => 盼盼集团
石家庄东明家具城 => 石家庄东明家具城
石家庄二手房装修 => 石家庄二手房装修
石家庄红星美凯龙 => 石家庄红星美凯龙
石英壁布 => 石英壁布
石英钟 => 石英钟
碗 => 碗
碟 => 碟
社会精英 => 社会精英
神诺陶瓷有限公司 => 神诺陶瓷有限公司
福州二手房装修 => 福州二手房装修
福湘木业 => 福湘木业
福湘板材 => 福湘板材
福达轩家具 => 福达轩家具
福雨丽莎瓷砖 => 福雨丽莎瓷砖
科宝橱柜 => 科宝橱柜
科隆五金展/亚太家居园艺消费品博览会 => 科隆五金展/亚太家居园艺消费品博览会
科隆国际五金博览会 => 科隆国际五金博览会
科隆国际家具生产 => 科隆国际家具生产
科隆家具展 => 科隆家具展
秦岭水泥 => 秦岭水泥
秦皇岛红星美凯龙 => 秦皇岛红星美凯龙
穗宝床垫 => 穗宝床垫
空调插座 => 空调插座
窗 => 窗
窗帘杆 => 窗帘杆
窗帘盒 => 窗帘盒
立升净水器 => 立升净水器
立邦乳胶漆 => 立邦乳胶漆
立邦净味 => 立邦净味
立邦净味全效 => 立邦净味全效
立邦美得丽 => 立邦美得丽
立邦色卡 => 立邦色卡
竹制工艺品 => 竹制工艺品
竹子工艺品 => 竹子工艺品
竹窗帘 => 竹窗帘
第七届广州国际酒店家具展 => 第七届广州国际酒店家具展
第五届中国哈尔滨(中俄)国际照明灯饰展览会 => 第五届中国哈尔滨(中俄)国际照明灯饰展览会
第八届亚洲国际家具材料博览会 => 第八届亚洲国际家具材料博览会
第四届中国国际建筑设计展览会 => 第四届中国国际建筑设计展览会
简一仿古砖 => 简一仿古砖
简一大理石 => 简一大理石
简一瓷砖 => 简一瓷砖
简一羊皮砖 => 简一羊皮砖
简一陶瓷 => 简一陶瓷
简约书桌 => 简约书桌
简约壁纸 => 简约壁纸
简约欧式风格 => 简约欧式风格
简约电视背景墙 => 简约电视背景墙
简约设计 => 简约设计
箭牌马桶箭牌洁具 => 箭牌马桶箭牌洁具
箱 => 箱
米兰办公家具展 => 米兰办公家具展
米兰厨房家具展 => 米兰厨房家具展
米兰国际灯具展 => 米兰国际灯具展
米兰装饰配套展 => 米兰装饰配套展
米尼照明 => 米尼照明
精装小户型 => 精装小户型
索尼投影仪 => 索尼投影仪
索尼投影机 => 索尼投影机
索尼投影机灯泡 => 索尼投影机灯泡
索尼电视机 => 索尼电视机
索恩照明 => 索恩照明
索菲亚家具 => 索菲亚家具
索菲亚整体衣柜 => 索菲亚整体衣柜
索菲亚移门 => 索菲亚移门
索菲亚衣柜 => 索菲亚衣柜
紫檀筷子 => 紫檀筷子
紫砂茶具 => 紫砂茶具
紫罗兰家纺 => 紫罗兰家纺
紫荆花乳胶漆 => 紫荆花乳胶漆
紫荆花墙面漆 => 紫荆花墙面漆
紫荆花木器漆 => 紫荆花木器漆
红塔 => 红塔
红塔木业 => 红塔木业
红塔木门 => 红塔木门
红太阳装饰城 => 红太阳装饰城
红旗家具城 => 红旗家具城
红木沙发 => 红木沙发
红树湾家具 => 红树湾家具
红苹果家具 => 红苹果家具
红苹果布艺沙发 => 红苹果布艺沙发
红苹果床垫 => 红苹果床垫
红苹果沙发 => 红苹果沙发
红蚂蚁装饰 => 红蚂蚁装饰
红蜘蛛瓷砖 => 红蜘蛛瓷砖
红蜘蛛陶瓷 => 红蜘蛛陶瓷
红豆家纺 => 红豆家纺
红鹤木门 => 红鹤木门
纳米涂料 => 纳米涂料
经典小户型 => 经典小户型
结婚礼品 => 结婚礼品
维科家纺 => 维科家纺
绿植镜子 => 绿植镜子
编织工艺品 => 编织工艺品
罐 => 罐
网店装修 => 网店装修
罗兰家纺 => 罗兰家纺
罗莱lovo => 罗莱lovo
罗莱家纺官方网站 => 罗莱家纺官方网站
罗马瓷砖 => 罗马瓷砖
美兆家具 => 美兆家具
美克美家家具 => 美克美家家具
美加华洁具 => 美加华洁具
美国别墅 => 美国别墅
美国厨房展 => 美国厨房展
美国国际厨房及卫浴产品展览会(K/BIS) => 美国国际厨房及卫浴产品展览会(K/BIS)
美国国际玻璃门窗展览会 => 美国国际玻璃门窗展览会
美国大师乳胶漆 => 美国大师乳胶漆
美国大师漆 => 美国大师漆
美国家居 => 美国家居
美国拉斯维加斯国际灯具展 => 美国拉斯维加斯国际灯具展
美国纽约国际灯具展览会 => 美国纽约国际灯具展览会
美国芝加哥国际家庭用品博览会 => 美国芝加哥国际家庭用品博览会
美容保养 => 美容保养
美容店 => 美容店
美尔凯特集成吊顶 => 美尔凯特集成吊顶
美居乐窗帘 => 美居乐窗帘
美巢 => 美巢
美巢易刮平 => 美巢易刮平
美巢腻子 => 美巢腻子
美巢腻子粉 => 美巢腻子粉
美庭装饰 => 美庭装饰
美式古典风格 => 美式古典风格
美式餐桌 => 美式餐桌
美心 => 美心
美心实木门 => 美心实木门
美心室内门 => 美心室内门
美心工艺门 => 美心工艺门
美心木门 => 美心木门
美心钢木门 => 美心钢木门
美心门业 => 美心门业
美心集团 => 美心集团
美标中国美标卫浴 => 美标中国美标卫浴
美的冰箱 => 美的冰箱
美的净水器 => 美的净水器
美的小家电 => 美的小家电
美的抽油烟机 => 美的抽油烟机
美的榨汁机 => 美的榨汁机
美的油烟机 => 美的油烟机
美的洗衣机 => 美的洗衣机
美的浴霸 => 美的浴霸
美的烤箱 => 美的烤箱
美的热水器 => 美的热水器
美的照明 => 美的照明
美的燃气热水器 => 美的燃气热水器
美的电压力锅 => 美的电压力锅
美的电热水器 => 美的电热水器
美的电磁炉 => 美的电磁炉
美的电饭煲 => 美的电饭煲
美的电饼铛 => 美的电饼铛
美的空气能热水器 => 美的空气能热水器
美的豆浆机 => 美的豆浆机
美的集团 => 美的集团
美的风扇 => 美的风扇
美的饮水机 => 美的饮水机
美罗家纺 => 美罗家纺
美陶地砖 => 美陶地砖
美陶瓷砖 => 美陶瓷砖
美陶陶瓷 => 美陶陶瓷
耀邦家具 => 耀邦家具
老板抽油烟机 => 老板抽油烟机
老板椅 => 老板椅
耐高温油漆 => 耐高温油漆
联塑 => 联塑
联塑水管 => 联塑水管
联塑管业 => 联塑管业
联塑管业集团 => 联塑管业集团
联塑管道 => 联塑管道
联塑集团 => 联塑集团
联排别墅 => 联排别墅
联邦家居 => 联邦家居
联邦家私 => 联邦家私
聚通装潢 => 聚通装潢
肯帝亚地板 => 肯帝亚地板
背景墙设计 => 背景墙设计
脚线 => 脚线
腻子粉 => 腻子粉
良业照明 => 良业照明
艺术砖 => 艺术砖
艺达家纺 => 艺达家纺
艾芙迪家具 => 艾芙迪家具
节日派对 => 节日派对
节能灯泡 => 节能灯泡
芬琳涂料 => 芬琳涂料
芬琳漆 => 芬琳漆
花艺制作 => 花艺制作
花艺图片 => 花艺图片
花草盆景 => 花草盆景
苏宁电器电话 => 苏宁电器电话
苏州二手房装修 => 苏州二手房装修
苏州别墅装修 => 苏州别墅装修
苏州华东装饰城 => 苏州华东装饰城
苏州博世 => 苏州博世
苏州家具城 => 苏州家具城
苏州小户型装修 => 苏州小户型装修
苏州月星家居 => 苏州月星家居
苏州樱花 => 苏州樱花
苏州百安居 => 苏州百安居
苏州美克美家 => 苏州美克美家
苏州苏宁电器 => 苏州苏宁电器
苏州金海马家具城 => 苏州金海马家具城
苏泊尔公司 => 苏泊尔公司
苏泊尔压力锅 => 苏泊尔压力锅
苏泊尔榨汁机 => 苏泊尔榨汁机
苏泊尔汤锅 => 苏泊尔汤锅
苏泊尔油烟机 => 苏泊尔油烟机
苏泊尔炒锅 => 苏泊尔炒锅
苏泊尔燃气灶 => 苏泊尔燃气灶
苏泊尔电压力锅 => 苏泊尔电压力锅
苏泊尔电器 => 苏泊尔电器
苏泊尔电水壶 => 苏泊尔电水壶
苏泊尔电磁炉 => 苏泊尔电磁炉
苏泊尔电饭煲 => 苏泊尔电饭煲
苏泊尔豆浆机 => 苏泊尔豆浆机
苏泊尔集团有限公司 => 苏泊尔集团有限公司
苏泊尔高压锅 => 苏泊尔高压锅
英国伯明翰国际建筑展览会 => 英国伯明翰国际建筑展览会
茶叶罐 => 茶叶罐
荣事达 => 荣事达
荣事达冰箱 => 荣事达冰箱
荣事达太阳能 => 荣事达太阳能
荣事达小家电 => 荣事达小家电
荣事达橱柜 => 荣事达橱柜
荣事达洗衣机 => 荣事达洗衣机
荣事达电磁炉 => 荣事达电磁炉
荣事达集团 => 荣事达集团
莫干山板材 => 莫干山板材
莹辉集团 => 莹辉集团
菲尔普壁纸涂料 => 菲尔普壁纸涂料
菲尔普壁纸涂料漆 => 菲尔普壁纸涂料漆
菲律宾风格 => 菲律宾风格
菲时特管业 => 菲时特管业
菲林格尔地板 => 菲林格尔地板
营口装修监理 => 营口装修监理
萨米特地砖 => 萨米特地砖
萨米特瓷砖 => 萨米特瓷砖
萨米特陶瓷 => 萨米特陶瓷
萨米特雅光砖 => 萨米特雅光砖
著名楼盘装修 => 著名楼盘装修
董功 => 董功
董忠仁 => 董忠仁
董易林 => 董易林
董都 => 董都
蒙娜丽莎卫浴 => 蒙娜丽莎卫浴
蒙娜丽莎地砖 => 蒙娜丽莎地砖
蒙娜丽莎洁具 => 蒙娜丽莎洁具
蒙娜丽莎瓷砖 => 蒙娜丽莎瓷砖
蒙娜丽莎陶瓷 => 蒙娜丽莎陶瓷
蒸汽房 => 蒸汽房
蓝丝羽 => 蓝丝羽
藤编篮 => 藤编篮
虚拟空间装修 => 虚拟空间装修
蜜蜂瓷砖 => 蜜蜂瓷砖
蜡烛台 => 蜡烛台
衡阳装修监理 => 衡阳装修监理
衣帽架 => 衣帽架
衣帽间家具 => 衣帽间家具
衣帽间门 => 衣帽间门
被面 => 被面
装修人群 => 装修人群
装修全包 => 装修全包
装修半包 => 装修半包
装修工程监理 => 装修工程监理
装修拆墙 => 装修拆墙
装修施工监理 => 装修施工监理
装修时间 => 装修时间
装修材料清单 => 装修材料清单
装修步骤 => 装修步骤
装修清包 => 装修清包
装修用途 => 装修用途
装修监理价格 => 装修监理价格
装修监理实施细则 => 装修监理实施细则
装修监理日记 => 装修监理日记
装修监理注意的地方 => 装修监理注意的地方
装修监理流程 => 装修监理流程
装修监理知识 => 装修监理知识
装修监理职责 => 装修监理职责
装修监理规范 => 装修监理规范
装修过程 => 装修过程
装饰城 => 装饰城
装饰搭配版块 => 装饰搭配版块
装饰灯具 => 装饰灯具
装饰画屏风 => 装饰画屏风
装饰监理 => 装饰监理
装饰隔断 => 装饰隔断
西安二手房装修 => 西安二手房装修
西安国美电器 => 西安国美电器
西安家具城 => 西安家具城
西安小户型装修 => 西安小户型装修
西安红星美凯龙 => 西安红星美凯龙
西安苏宁电器 => 西安苏宁电器
西安装修 => 西安装修
西安装修监理 => 西安装修监理
西班牙家居 => 西班牙家居
西部家具城 => 西部家具城
西铁龙锁具 => 西铁龙锁具
西门子公司 => 西门子公司
西门子冰箱 => 西门子冰箱
西门子厨房电器 => 西门子厨房电器
西门子官网 => 西门子官网
西门子家电 => 西门子家电
西门子油烟机 => 西门子油烟机
西门子洗衣机 => 西门子洗衣机
西门子滚筒洗衣机 => 西门子滚筒洗衣机
西门子灶具 => 西门子灶具
西门子热水器 => 西门子热水器
西门子电器 => 西门子电器
西门子自动化 => 西门子自动化
西门子论坛 => 西门子论坛
西顿照明 => 西顿照明
誉丰地板 => 誉丰地板
设备展 => 设备展
诺捷家具 => 诺捷家具
诺贝尔地砖 => 诺贝尔地砖
诺贝尔陶瓷 => 诺贝尔陶瓷
象牙筷子 => 象牙筷子
贝壳工艺品 => 贝壳工艺品
贝特装饰 => 贝特装饰
贝聿铭 => 贝聿铭
贝雷塔壁挂炉 => 贝雷塔壁挂炉
贴地板砖 => 贴地板砖
贴地板砖价格 => 贴地板砖价格
贴地板砖注意事项 => 贴地板砖注意事项
贴砖人工 => 贴砖人工
贴砖价格 => 贴砖价格
贴砖工艺 => 贴砖工艺
贴砖施工工艺 => 贴砖施工工艺
贴砖注意 => 贴砖注意
贵族床垫 => 贵族床垫
走廊装修 => 走廊装修
赵仲贵 => 赵仲贵
超人小家电 => 超人小家电
超出预算 => 超出预算
跃层楼梯 => 跃层楼梯
跃层装修 => 跃层装修
车飞 => 车飞
转换插座 => 转换插座
软陶工艺品 => 软陶工艺品
轻舟装饰 => 轻舟装饰
辉煌卫浴 => 辉煌卫浴
辽宁盼盼 => 辽宁盼盼
达芬奇家具 => 达芬奇家具
达芬奇家居 => 达芬奇家居
过道吊顶 => 过道吊顶
过道灯 => 过道灯
过道背景墙 => 过道背景墙
过道设计 => 过道设计
迪信家具 => 迪信家具
迪士尼家具 => 迪士尼家具
迪拜国际厨房 => 迪拜国际厨房
迪拜国际厨房、卫浴博览会 => 迪拜国际厨房、卫浴博览会
迪梦莎家纺 => 迪梦莎家纺
通用锁具 => 通用锁具
遮光窗帘 => 遮光窗帘
邓禄普床垫 => 邓禄普床垫
郑州二手家电 => 郑州二手家电
郑州二手房装修 => 郑州二手房装修
郑州国美电器 => 郑州国美电器
郑州家具城 => 郑州家具城
郑州小户型装修 => 郑州小户型装修
郑州居然之家 => 郑州居然之家
郑州永乐电器 => 郑州永乐电器
郑州苏宁电器 => 郑州苏宁电器
酒吧装修风格 => 酒吧装修风格
采暖品牌 => 采暖品牌
采暖展 => 采暖展
重庆二手房装修 => 重庆二手房装修
重庆别墅装修 => 重庆别墅装修
重庆国美电器 => 重庆国美电器
重庆家具城 => 重庆家具城
重庆小户型装修 => 重庆小户型装修
重庆居然之家 => 重庆居然之家
重庆建博会-绿色建材及建筑装饰展 => 重庆建博会-绿色建材及建筑装饰展
重庆建材展 => 重庆建材展
重庆格力 => 重庆格力
重庆格力空调 => 重庆格力空调
重庆百安居 => 重庆百安居
重庆红星美凯龙 => 重庆红星美凯龙
重庆美克美家 => 重庆美克美家
重庆美心集团 => 重庆美心集团
重庆苏宁电器 => 重庆苏宁电器
重庆装修 => 重庆装修
重庆装修监理 => 重庆装修监理
重庆门窗幕墙与玻璃工业展 => 重庆门窗幕墙与玻璃工业展
金三优装修 => 金三优装修
金利源净水器 => 金利源净水器
金属工艺品 => 金属工艺品
金属马赛克 => 金属马赛克
金德ppr管 => 金德ppr管
金德ppr管型号 => 金德ppr管型号
金德管 => 金德管
金德管业 => 金德管业
金德集团 => 金德集团
金意陶仿古砖 => 金意陶仿古砖
金意陶地砖 => 金意陶地砖
金意陶瓷砖 => 金意陶瓷砖
金意陶陶瓷 => 金意陶陶瓷
金意陶陶瓷有限公司 => 金意陶陶瓷有限公司
金欧雅瓷砖 => 金欧雅瓷砖
金欧雅陶瓷 => 金欧雅陶瓷
金海马家具城 => 金海马家具城
金牌洁具 => 金牌洁具
金牛管 => 金牛管
金牛管业 => 金牛管业
金科瓷砖 => 金科瓷砖
金科陶瓷 => 金科陶瓷
金舵地砖 => 金舵地砖
金舵瓷砖 => 金舵瓷砖
金舵陶瓷 => 金舵陶瓷
金舵陶瓷有限公司 => 金舵陶瓷有限公司
金隅北木 => 金隅北木
鑫森装饰 => 鑫森装饰
钜豪 => 钜豪
钜豪灯具 => 钜豪灯具
钜豪灯饰 => 钜豪灯饰
钜豪照明 => 钜豪照明
钟 => 钟
钟明政 => 钟明政
钢木楼梯 => 钢木楼梯
钢结构北京展览会-第九届中国北京国际建筑钢结构展览会 => 钢结构北京展览会-第九届中国北京国际建筑钢结构展览会
钻石椅 => 钻石椅
铁艺家具 => 铁艺家具
银晶卫浴 => 银晶卫浴
银筷子 => 银筷子
银雨灯饰 => 银雨灯饰
银雨照明 => 银雨照明
锁 => 锁
锁芯 => 锁芯
锅 => 锅
锦华装饰 => 锦华装饰
镂空隔断 => 镂空隔断
长城瓷砖 => 长城瓷砖
长安瓷砖 => 长安瓷砖
长春二手房装修 => 长春二手房装修
长春吉盛伟邦 => 长春吉盛伟邦
长春苏宁电器 => 长春苏宁电器
长江散热器 => 长江散热器
长沙二手房装修 => 长沙二手房装修
长沙博世 => 长沙博世
长沙国美电器 => 长沙国美电器
长沙小户型装修 => 长沙小户型装修
长沙李文锁城 => 长沙李文锁城
长沙红星美凯龙 => 长沙红星美凯龙
长沙苏宁电器 => 长沙苏宁电器
长沙装修监理 => 长沙装修监理
长沙装修监理公司 => 长沙装修监理公司
长虹佳华 => 长虹佳华
长虹官网 => 长虹官网
长虹液晶电视 => 长虹液晶电视
长虹电器 => 长虹电器
长虹空调 => 长虹空调
长虹等离子 => 长虹等离子
长虹等离子电视 => 长虹等离子电视
长虹集团 => 长虹集团
长谷瓷砖 => 长谷瓷砖
门 => 门
门厅柜 => 门厅柜
门厅装修 => 门厅装修
门窗五金 => 门窗五金
门窗幕墙展 => 门窗幕墙展
闷锅 => 闷锅
阁楼吊顶 => 阁楼吊顶
阔达装饰 科宝·博洛尼 => 阔达装饰 科宝·博洛尼
防滑地砖 => 防滑地砖
防火板 => 防火板
防腐木地板 => 防腐木地板
防锈漆 => 防锈漆
阳光别墅 => 阳光别墅
阳光照明 => 阳光照明
阳台地砖 => 阳台地砖
阳台花园 => 阳台花园
阳台花架 => 阳台花架
阳台装修效果图 => 阳台装修效果图
阿波罗卫浴 => 阿波罗卫浴
阿里斯顿冰箱 => 阿里斯顿冰箱
阿里斯顿壁挂炉 => 阿里斯顿壁挂炉
阿里斯顿烤箱 => 阿里斯顿烤箱
阿里斯顿热水器 => 阿里斯顿热水器
阿里斯顿燃气灶 => 阿里斯顿燃气灶
阿里斯顿燃气热水器 => 阿里斯顿燃气热水器
阿里斯顿电热水器 => 阿里斯顿电热水器
阿里斯顿集成吊顶 => 阿里斯顿集成吊顶
陇星散热器 => 陇星散热器
陈凌 => 陈凌
陈耕 => 陈耕
陋室装饰 => 陋室装饰
陶瓷地砖 => 陶瓷地砖
陶瓷花瓶 => 陶瓷花瓶
陶瓷茶具 => 陶瓷茶具
陶瓷马赛克 => 陶瓷马赛克
隆美窗帘 => 隆美窗帘
隔墙 => 隔墙
隔断帘 => 隔断帘
雅兰床上用品 => 雅兰床上用品
雅兰床垫 => 雅兰床垫
雅居乐 => 雅居乐
雅居仕液体壁纸 => 雅居仕液体壁纸
雅洁五金 => 雅洁五金
雅皮 => 雅皮
雅致主义 => 雅致主义
雅致人生 => 雅致人生
集美家具 => 集美家具
集美家具城 => 集美家具城
雕刻工艺品 => 雕刻工艺品
雕花隔断 => 雕花隔断
雨兰家纺 => 雨兰家纺
雪尼尔地毯 => 雪尼尔地毯
雷克照明 => 雷克照明
雷士家居照明 => 雷士家居照明
雷士灯具 => 雷士灯具
雷士照明官方网站 => 雷士照明官方网站
雷士电工 => 雷士电工
霍尔茨 => 霍尔茨
霍尔茨木门 => 霍尔茨木门
露台植物 => 露台植物
露台装修 => 露台装修
露台装修图片 => 露台装修图片
露台阳光房 => 露台阳光房
露水河板材 => 露水河板材
青岛二手房装修 => 青岛二手房装修
青岛国美电器 => 青岛国美电器
青岛国际LED显示屏及城市节能照明展览会 => 青岛国际LED显示屏及城市节能照明展览会
青岛百安居 => 青岛百安居
青岛苏宁电器 => 青岛苏宁电器
青岛装修 => 青岛装修
青岛装修公司 => 青岛装修公司
青岛装饰城 => 青岛装饰城
靓家居 => 靓家居
韩丽橱柜 => 韩丽橱柜
韩国家居哥特建筑 => 韩国家居哥特建筑
韩国餐具 => 韩国餐具
韩锋 => 韩锋
音响diy => 音响diy
顶固 => 顶固
顶固五金 => 顶固五金
顶固推拉门 => 顶固推拉门
顶固整体衣柜 => 顶固整体衣柜
顶固移门 => 顶固移门
顶固衣柜 => 顶固衣柜
顾家家具 => 顾家家具
顾家工艺 => 顾家工艺
顾家工艺沙发 => 顾家工艺沙发
顾家沙发 => 顾家沙发
顾家沙发图片 => 顾家沙发图片
顾家门业 => 顾家门业
风景装饰画 => 风景装饰画
飘窗书桌 => 飘窗书桌
飞利浦台灯 => 飞利浦台灯
飞利浦吸尘器 => 飞利浦吸尘器
飞利浦官网 => 飞利浦官网
飞利浦榨汁机 => 飞利浦榨汁机
飞利浦液晶电视 => 飞利浦液晶电视
飞利浦电视 => 飞利浦电视
飞利浦音响 => 飞利浦音响
飞利浦音箱 => 飞利浦音箱
餐厅吊灯 => 餐厅吊灯
餐厅装饰画 => 餐厅装饰画
餐巾纸 => 餐巾纸
餐桌布 => 餐桌布
饮食店 => 饮食店
饰品diy => 饰品diy
饰品品牌 => 饰品品牌
香山别墅 => 香山别墅
香樟木家具 => 香樟木家具
香河家具城班车 => 香河家具城班车
香港秋季国际灯饰展览会 => 香港秋季国际灯饰展览会
香港装修 => 香港装修
香薰灯 => 香薰灯
香薰蜡烛 => 香薰蜡烛
马勒别墅 => 马勒别墅
马可波罗仿古砖 => 马可波罗仿古砖
马可波罗卫浴 => 马可波罗卫浴
马可波罗地砖 => 马可波罗地砖
马可波罗瓷砖 => 马可波罗瓷砖
马可波罗陶瓷 => 马可波罗陶瓷
骨瓷餐具 => 骨瓷餐具
高压锅 => 高压锅
高尔夫别墅 => 高尔夫别墅
高志 => 高志
高隔断 => 高隔断
鲜花店 => 鲜花店
鲜花礼品 => 鲜花礼品
鳄鱼漆 => 鳄鱼漆
鹰牌卫浴 => 鹰牌卫浴
鹰牌坐便器 => 鹰牌坐便器
鹰牌洁具 => 鹰牌洁具
鹰牌瓷砖 => 鹰牌瓷砖
麒麟床垫 => 麒麟床垫
黑川纪章 => 黑川纪章
黑白装饰画 => 黑白装饰画
黑色家电 => 黑色家电
黛富妮 => 黛富妮
齐方 => 齐方
齐欣 => 齐欣
龙发装饰 => 龙发装饰
龙头（水龙头） => 龙头（水龙头）
龙牌石膏板 => 龙牌石膏板
龙瑞装饰 => 龙瑞装饰
龙翔床垫 => 龙翔床垫
